SellingID,BranchID,Phase,UnitType,UnitClass,LotPrice,MCF,TCP,EffectiveDate,Recuser
1,12,1,FE,PR,1425000,475000,1900000,7/3/2024,User1
2,12,1,LLO,PR,36000,12000,48000,7/3/2024,User1
3,12,1,LL,PM,71250,23750,95000,7/3/2024,User1
4,12,1,LL,SP,78750,26250,105000,7/3/2024,User1
5,12,1,LL,PR,90000,30000,120000,7/3/2024,User1
6,12,1,LL-S,PM,78750,26250,105000,7/3/2024,User1
7,12,1,GN,PM,300000,100000,400000,7/3/2024,User1
8,12,2,LL,SP,78750,26250,105000,7/3/2024,User1
9,12,2,LL,PR,90000,30000,120000,7/3/2024,User1
10,12,2,GN,PM,300000,100000,400000,7/3/2024,User1
11,12,2,GN,SP,318750,106250,425000,7/3/2024,User1
12,12,2,GN,PR,363750,121250,485000,7/3/2024,User1
13,12,2,FP,PM,562500,187500,750000,7/3/2024,User1
14,12,1,FE,PM,1200000,400000,1600000,7/1/2024,User1
15,12,1,FE,PR,1350000,450000,1800000,7/1/2024,User1
16,12,1,LLO,PR,36000,12000,48000,7/1/2024,User1
17,12,1,LL-S,PM,78750,26250,105000,7/1/2024,User1
18,12,1,LL-S,SP,86250,28750,115000,7/1/2024,User1
19,12,1,LL-S,PR,97500,32500,130000,7/1/2024,User1
20,12,1,LL,PM,71250,23750,95000,7/1/2024,User1
21,12,1,LL,SP,78750,26250,105000,7/1/2024,User1
22,12,1,LL,SP,78750,26250,105000,6/30/2024,User1
23,12,1,LL,PR,90000,30000,120000,6/30/2024,User1
24,12,1,GN,PM,300000,100000,400000,6/30/2024,User1
25,12,1,GN,SP,318750,106250,425000,6/30/2024,User1
26,12,1,GN,PR,363750,121250,485000,6/30/2024,User1
27,12,1,FP,PM,562500,187500,750000,6/30/2024,User1
28,12,1,FP,PR,637500,212500,850000,6/30/2024,User1
29,12,1,FE,PM,1200000,400000,1600000,6/30/2024,User1
30,12,1,FE,PR,1350000,450000,1800000,6/30/2024,User1
31,12,1,LLO,PR,36000,12000,48000,6/30/2024,User1
32,12,1,LL-S,PM,78750,26250,105000,6/30/2024,User1
33,12,1,LL-S,SP,86250,28750,115000,6/30/2024,User1
34,12,1,LL-S,PR,97500,32500,130000,6/30/2024,User1
35,12,1,LL,PM,71250,23750,95000,6/30/2024,User1
36,12,1,LL-S,SP,90000,30000,120000,7/3/2024,User1
37,12,1,LL-S,PR,97500,32500,130000,7/3/2024,User1
38,12,1,GN,SP,318750,106250,425000,7/3/2024,User1
39,12,1,GN,PR,363750,121250,485000,7/3/2024,User1
40,12,1,FP,PM,562500,187500,750000,7/3/2024,User1
41,12,1,FP,PR,637500,212500,850000,7/3/2024,User1
42,12,1,FE,PM,1275000,425000,1700000,7/3/2024,User1
43,12,2,FP,PR,637500,212500,850000,7/3/2024,User1
44,12,2,FE,PM,1125000,375000,1500000,7/3/2024,User1
45,12,2,FE,PR,1237500,412500,1650000,7/3/2024,User1
46,12,2,LL,PM,71250,23750,95000,7/3/2024,User1
47,12,1,FE,PM,1200000,400000,1600000,4/27/2024,User1
48,12,1,FE,PR,1350000,450000,1800000,4/27/2024,User1
49,12,1,LLO,PR,36000,12000,48000,4/27/2024,User1
50,12,1,LL,SP,78750,26250,105000,4/27/2024,User1
51,12,1,LL,PR,90000,30000,120000,4/27/2024,User1
52,12,1,GN,PM,300000,100000,400000,4/27/2024,User1
53,12,1,LL,PM,71250,23750,95000,4/27/2024,User1
54,12,1,FP,PR,637500,212500,850000,4/27/2024,User1
55,12,1,GN,SP,318750,106250,425000,4/27/2024,User1
56,12,1,GN,PR,363750,121250,485000,4/27/2024,User1
57,12,1,FP,PM,562500,187500,750000,4/27/2024,User1
58,12,1,LL,PM,71250,23750,95000,2/28/2024,User1
59,12,1,LL,SP,78750,26250,105000,2/28/2024,User1
60,12,1,LL,PR,90000,30000,120000,2/28/2024,User1
61,12,1,GN,PM,300000,100000,400000,2/28/2024,User1
62,12,1,GN,PR,363750,121250,485000,2/28/2024,User1
63,12,1,GN,SP,318750,106250,425000,2/28/2024,User1
64,12,1,GN,SP,363750,121250,485000,2/28/2024,User1
65,12,1,FP,PM,562500,187500,750000,2/28/2024,User1
66,12,1,FP,PR,637500,212500,850000,2/28/2024,User1
67,12,1,FE,PM,1200000,400000,1600000,2/28/2024,User1
68,12,1,FE,PR,1350000,450000,1800000,2/28/2024,User1
69,12,1,LLO,PR,36000,12000,48000,2/28/2024,User1
70,12,2,LL,PM,67500,22500,90000,2/28/2024,User1
71,12,2,LL,SP,69750,23250,93000,2/28/2024,User1
72,12,2,LL,PR,73500,24500,98000,2/28/2024,User1
73,12,2,GN,PM,285000,95000,380000,2/28/2024,User1
74,12,2,GN,PR,307500,102500,410000,2/28/2024,User1
75,12,2,GN,SP,292500,97500,390000,2/28/2024,User1
76,12,2,FP,PM,517500,172500,690000,2/28/2024,User1
77,12,2,FP,PR,540000,180000,720000,2/28/2024,User1
78,12,2,FE,PM,1050000,350000,1400000,2/28/2024,User1
79,12,2,FE,PR,1087500,362500,1450000,2/28/2024,User1
80,12,2,LLO,PR,36000,12000,48000,2/28/2024,User1
81,12,2,LL,PM,67500,22500,90000,4/27/2024,User1
82,12,1,LL,SP,78750,26250,105000,5/6/2024,User1
83,12,1,LL,PR,90000,30000,120000,5/6/2024,User1
84,12,1,GN,PM,300000,100000,400000,5/6/2024,User1
85,12,1,LL,PM,71250,23750,95000,5/6/2024,User1
86,12,1,GN,SP,318750,106250,425000,5/6/2024,User1
87,12,1,GN,PR,363750,121250,485000,5/6/2024,User1
88,12,1,FP,PM,562500,187500,750000,5/6/2024,User1
89,12,1,FP,PR,637500,212500,850000,5/6/2024,User1
90,12,1,FE,PM,1200000,400000,1600000,5/6/2024,User1
91,12,1,FE,PR,1350000,450000,1800000,5/6/2024,User1
92,12,1,LLO,PR,36000,12000,48000,5/6/2024,User1
93,12,2,FP,PR,540000,180000,720000,5/6/2024,User1
94,12,2,FE,PM,1050000,350000,1400000,5/6/2024,User1
95,12,2,FE,PR,1087500,362500,1450000,5/6/2024,User1
96,12,2,LL,PM,67500,22500,90000,5/6/2024,User1
97,12,2,LL,SP,69750,23250,93000,5/6/2024,User1
98,12,2,LL,PR,73500,24500,98000,5/6/2024,User1
99,12,2,GN,PM,285000,95000,380000,5/6/2024,User1
100,12,2,GN,SP,292500,97500,390000,5/6/2024,User1
101,12,2,GN,PR,307500,102500,410000,5/6/2024,User1
102,12,2,FP,PM,517500,172500,690000,5/6/2024,User1
103,12,2,LL,SP,69750,23250,93000,4/27/2024,User1
104,12,2,LL,PR,73500,24500,98000,4/27/2024,User1
105,12,2,GN,PM,285000,95000,380000,4/27/2024,User1
106,12,2,GN,SP,292500,97500,390000,4/27/2024,User1
107,12,2,GN,PR,307500,102500,410000,4/27/2024,User1
108,12,2,FP,PM,517500,172500,690000,4/27/2024,User1
109,12,2,FP,PR,540000,180000,720000,4/27/2024,User1
110,12,2,FE,PM,1050000,350000,1400000,4/27/2024,User1
111,12,2,FE,PR,1087500,362500,1450000,4/27/2024,User1
112,12,1,LL,PM,71250,23750,95000,5/30/2024,User1
113,12,1,LL,SP,78750,26250,105000,5/30/2024,User1
114,12,1,LL,PR,90000,30000,120000,5/30/2024,User1
115,12,1,GN,PM,300000,100000,400000,5/30/2024,User1
116,12,1,GN,SP,318750,106250,425000,5/30/2024,User1
117,12,1,GN,PR,363750,121250,485000,5/30/2024,User1
118,12,2,LL,PM,71250,23750,95000,9/3/2024,User1
119,12,1,FP,PM,562500,187500,750000,5/30/2024,User1
120,12,1,FP,PR,637500,212500,850000,5/30/2024,User1
121,12,1,FE,PM,1200000,400000,1600000,5/30/2024,User1
122,12,1,FE,PR,1350000,450000,1800000,5/30/2024,User1
123,12,1,LLO,PR,36000,12000,48000,5/30/2024,User1
124,12,2,FP,PM,517500,172500,690000,5/30/2024,User1
125,12,2,FP,PR,540000,180000,720000,5/30/2024,User1
126,12,2,FE,PM,1050000,350000,1400000,5/30/2024,User1
127,12,2,FE,PR,1087500,362500,1450000,5/30/2024,User1
128,12,2,LL,PM,67500,22500,90000,5/30/2024,User1
129,12,2,LL,SP,69750,23250,93000,5/30/2024,User1
130,12,2,LL,PR,73500,24500,98000,5/30/2024,User1
131,12,2,GN,PM,285000,95000,380000,5/30/2024,User1
132,12,2,GN,SP,292500,97500,390000,5/30/2024,User1
133,12,2,GN,PR,307500,102500,410000,5/30/2024,User1
134,12,1,LL,PM,71250,23750,95000,8/24/2024,User1
135,12,1,LL,SP,78750,26250,105000,8/24/2024,User1
136,12,1,LL,PR,90000,30000,120000,8/24/2024,User1
137,12,1,LL-S,PM,82500,27500,110000,8/24/2024,User1
138,12,1,LL-S,PM,78750,26250,105000,7/31/2024,User1
139,12,1,LL,SP,78750,26250,105000,7/31/2024,User1
140,12,1,LL,PR,90000,30000,120000,7/31/2024,User1
141,12,1,LL-S,SP,90000,30000,120000,7/31/2024,User1
142,12,1,LL-S,PR,97500,32500,130000,7/31/2024,User1
143,12,1,GN,PM,300000,100000,400000,7/31/2024,User1
144,12,1,GN,SP,318750,106250,425000,7/31/2024,User1
145,12,1,GN,PR,363750,121250,485000,7/31/2024,User1
146,12,2,LL,SP,78750,26250,105000,9/3/2024,User1
147,12,2,LL,PR,90000,30000,120000,9/3/2024,User1
148,12,2,GN,PM,300000,100000,400000,9/3/2024,User1
149,12,2,GN,SP,318750,106250,425000,9/3/2024,User1
150,12,1,FP,PM,562500,187500,750000,7/31/2024,User1
151,12,1,FP,PR,637500,212500,850000,7/31/2024,User1
152,12,1,FE,PM,1275000,425000,1700000,7/31/2024,User1
153,12,1,FE,PR,1425000,475000,1900000,7/31/2024,User1
154,12,1,FE,PM,1425000,475000,1900000,7/31/2024,User1
155,12,1,LLO,PR,36000,12000,48000,7/31/2024,User1
156,12,1,LL,PM,71250,23750,95000,7/31/2024,User1
157,12,2,GN,PR,363750,121250,485000,9/3/2024,User1
158,12,2,FP,PM,562500,187500,750000,9/3/2024,User1
159,12,2,FP,PR,637500,212500,850000,9/3/2024,User1
160,12,2,FE,PM,1125000,375000,1500000,9/3/2024,User1
161,12,2,FE,PR,1237500,412500,1650000,9/3/2024,User1
162,12,2,FE-S,PM,1275000,425000,1700000,9/3/2024,User1
163,12,2,FE-S,PR,1575000,525000,2100000,9/3/2024,User1
164,12,1,LL,SP,78750,26250,105000,8/8/2024,User1
165,12,1,LL,PR,90000,30000,120000,8/8/2024,User1
166,12,2,LL,SP,78750,26250,105000,7/31/2024,User1
167,12,2,LL,PR,90000,30000,120000,7/31/2024,User1
168,12,2,GN,PM,300000,100000,400000,7/31/2024,User1
169,12,2,GN,SP,318750,106250,425000,7/31/2024,User1
170,12,2,GN,PR,363750,121250,485000,7/31/2024,User1
171,12,2,FP,PM,562500,187500,750000,7/31/2024,User1
172,12,2,FP,PR,637500,212500,850000,7/31/2024,User1
173,12,2,FE,PM,1125000,375000,1500000,7/31/2024,User1
174,12,2,FE,PR,1237500,412500,1650000,7/31/2024,User1
175,12,2,FE,PM,1237500,412500,1650000,7/31/2024,User1
176,12,2,LL,PM,71250,23750,95000,7/31/2024,User1
177,12,1,LL-S,SP,97500,32500,130000,8/24/2024,User1
178,12,1,LL-S,PR,112500,37500,150000,8/24/2024,User1
179,12,1,GN,PM,300000,100000,400000,8/24/2024,User1
180,12,1,GN,SP,318750,106250,425000,8/24/2024,User1
181,12,1,GN,PR,363750,121250,485000,8/24/2024,User1
182,12,1,FP,PM,562500,187500,750000,8/24/2024,User1
183,12,1,FP,PR,637500,212500,850000,8/24/2024,User1
184,12,1,FE,PM,1275000,425000,1700000,8/24/2024,User1
185,12,1,FE,PR,1425000,475000,1900000,8/24/2024,User1
186,12,1,LLO,PR,36000,12000,48000,8/24/2024,User1
187,12,2,LL,PM,71250,23750,95000,8/25/2024,User1
188,12,2,LL,SP,78750,26250,105000,8/25/2024,User1
189,12,2,LL,PR,90000,30000,120000,8/25/2024,User1
190,12,2,GN,PM,300000,100000,400000,8/25/2024,User1
191,12,2,GN,SP,318750,106250,425000,8/25/2024,User1
192,12,2,GN,PR,363750,121250,485000,8/25/2024,User1
193,12,2,FP,PM,562500,187500,750000,8/25/2024,User1
194,12,2,FP,PR,637500,212500,850000,8/25/2024,User1
195,12,2,FE,PM,1125000,375000,1500000,8/25/2024,User1
196,12,2,FE,PR,1237500,412500,1650000,8/25/2024,User1
197,12,2,LL,SP,78750,26250,105000,8/24/2024,User1
198,12,2,LL,PR,90000,30000,120000,8/24/2024,User1
199,12,2,GN,PM,300000,100000,400000,8/24/2024,User1
200,12,2,GN,SP,318750,106250,425000,8/24/2024,User1
201,12,2,GN,PR,363750,121250,485000,8/24/2024,User1
202,12,2,FP,PM,562500,187500,750000,8/24/2024,User1
203,12,2,FP,PR,637500,212500,850000,8/24/2024,User1
204,12,2,FE,PM,1125000,375000,1500000,8/24/2024,User1
205,12,2,FE,PR,1237500,412500,1650000,8/24/2024,User1
206,12,2,LL,PM,71250,23750,95000,8/24/2024,User1
207,12,1,LL-S,PM,82500,27500,110000,8/25/2024,User1
208,12,1,LL-S,SP,97500,32500,130000,8/25/2024,User1
209,12,1,LL-S,PR,112500,37500,150000,8/25/2024,User1
210,12,1,GN,PM,300000,100000,400000,8/25/2024,User1
211,12,1,GN,SP,318750,106250,425000,8/25/2024,User1
212,12,1,GN,PR,363750,121250,485000,8/25/2024,User1
213,12,1,FP,PM,562500,187500,750000,8/25/2024,User1
214,12,1,FP,PR,637500,212500,850000,8/25/2024,User1
215,12,1,FE,PM,1275000,425000,1700000,8/25/2024,User1
216,12,1,FE,PR,1425000,475000,1900000,8/25/2024,User1
217,12,1,LLO,PR,36000,12000,48000,8/25/2024,User1
218,12,1,LL,PM,71250,23750,95000,8/25/2024,User1
219,12,1,LL,SP,78750,26250,105000,8/25/2024,User1
220,12,1,LL,PR,90000,30000,120000,8/25/2024,User1
221,12,1,LL-S,PM,82500,27500,110000,8/8/2024,User1
222,12,1,LL-S,SP,97500,32500,130000,8/8/2024,User1
223,12,1,LL-S,PR,112500,37500,150000,8/8/2024,User1
224,12,1,GN,PM,300000,100000,400000,8/8/2024,User1
225,12,1,GN,SP,318750,106250,425000,8/8/2024,User1
226,12,1,GN,PR,363750,121250,485000,8/8/2024,User1
227,12,1,FP,PM,562500,187500,750000,8/8/2024,User1
228,12,1,FP,PR,637500,212500,850000,8/8/2024,User1
229,12,1,FE,PM,1275000,425000,1700000,8/8/2024,User1
230,12,1,FE,PR,1425000,475000,1900000,8/8/2024,User1
231,12,1,LLO,PR,36000,12000,48000,8/8/2024,User1
232,12,1,LL,PM,71250,23750,95000,8/8/2024,User1
233,12,1,LL,PR,90000,30000,120000,7/1/2024,User1
234,12,1,GN,PM,300000,100000,400000,7/1/2024,User1
235,12,1,GN,SP,318750,106250,425000,7/1/2024,User1
236,12,1,GN,PR,363750,121250,485000,7/1/2024,User1
237,12,1,FP,PM,562500,187500,750000,7/1/2024,User1
238,12,1,FP,PR,637500,212500,850000,7/1/2024,User1
239,14,1,FE,SP,1655500,494500,2150000,1/17/2024,User1
240,14,1,GN,PM,485100,144900,630000,1/17/2024,User1
241,14,1,GN,PR,523600,156400,680000,1/17/2024,User1
242,14,1,LL,PM,111650,33350,145000,1/17/2024,User1
243,14,1,LL,PR,127050,37950,165000,1/17/2024,User1
244,14,1,LL,SP,119350,35650,155000,1/17/2024,User1
245,14,1,LL-S,PM,117040,34960,152000,1/17/2024,User1
246,14,1,LL-S,PR,130900,39100,170000,1/17/2024,User1
247,14,1,LL-S,SP,123200,36800,160000,1/17/2024,User1
248,14,1,FE,PM,1578500,471500,2050000,1/17/2024,User1
249,14,1,FE,PR,1809500,540500,2350000,1/17/2024,User1
250,14,1,FE,PM,1578500,471500,2050000,3/23/2024,User1
251,14,1,FE,PR,1809500,540500,2350000,3/23/2024,User1
252,14,1,FE,SP,1655500,494500,2150000,3/23/2024,User1
253,14,1,GN,PM,485100,144900,630000,3/23/2024,User1
254,14,1,GN,PR,523600,156400,680000,3/23/2024,User1
255,14,1,LL,PM,111650,33350,145000,3/23/2024,User1
256,14,1,LL,PR,127050,37950,165000,3/23/2024,User1
257,14,1,LL,SP,119350,35650,155000,3/23/2024,User1
258,14,1,LL-S,PM,117040,34960,152000,3/23/2024,User1
259,14,1,LL-S,PR,130900,39100,170000,3/23/2024,User1
260,14,1,LL-S,SP,123200,36800,160000,3/23/2024,User1
261,14,1,FE,PM,1617000,483000,2100000,9/25/2024,User1
262,14,1,FE,PR,1925000,575000,2500000,9/25/2024,User1
263,14,1,FE,SP,1732500,517500,2250000,9/25/2024,User1
264,14,1,FE,SP,2454760,733240,3188000,9/25/2024,User1
265,14,1,GN,PM,515900,154100,670000,9/25/2024,User1
266,14,1,GN,PR,577500,172500,750000,9/25/2024,User1
267,14,1,LL,PM,119350,35650,155000,9/25/2024,User1
268,14,1,LL,PR,134750,40250,175000,9/25/2024,User1
269,14,1,LL,SP,127050,37950,165000,9/25/2024,User1
270,14,1,LL-S,PM,123200,36800,160000,9/25/2024,User1
271,14,1,LL-S,PR,154000,46000,200000,9/25/2024,User1
272,14,1,LL-S,SP,134750,40250,175000,9/25/2024,User1
273,14,1,FE,PR,1925000,575000,2500000,7/3/2024,User1
274,14,1,FE,SP,1732500,517500,2250000,7/3/2024,User1
275,14,1,GN,PM,515900,154100,670000,7/3/2024,User1
276,14,1,GN,PR,577500,172500,750000,7/3/2024,User1
277,14,1,LL,PM,119350,35650,155000,7/3/2024,User1
278,14,1,LL,PR,134750,40250,175000,7/3/2024,User1
279,14,1,LL,SP,127050,37950,165000,7/3/2024,User1
280,14,1,LL-S,PM,123200,36800,160000,7/3/2024,User1
281,14,1,LL-S,PR,154000,46000,200000,7/3/2024,User1
282,14,1,LL-S,SP,134750,40250,175000,7/3/2024,User1
283,14,1,FE,PM,1617000,483000,2100000,7/3/2024,User1
284,14,1,FE,SP,1732500,517500,2250000,5/20/2024,User1
285,14,1,GN,PM,515900,154100,670000,5/20/2024,User1
286,14,1,GN,PR,577500,172500,750000,5/20/2024,User1
287,14,1,LL,PM,119350,35650,155000,5/20/2024,User1
288,14,1,LL,PR,134750,40250,175000,5/20/2024,User1
289,14,1,LL,SP,127050,37950,165000,5/20/2024,User1
290,14,1,LL-S,PM,123200,36800,160000,5/20/2024,User1
291,14,1,LL-S,PR,154000,46000,200000,5/20/2024,User1
292,14,1,LL-S,SP,134750,40250,175000,5/20/2024,User1
293,14,1,FE,PM,1617000,483000,2100000,5/20/2024,User1
294,14,1,FE,PR,1925000,575000,2500000,5/20/2024,User1
295,14,1,FE,SP,1732500,517500,2250000,5/21/2024,User1
296,14,1,GN,PM,515900,154100,670000,5/21/2024,User1
297,14,1,GN,PR,577500,172500,750000,5/21/2024,User1
298,14,1,LL,PM,119350,35650,155000,5/21/2024,User1
299,14,1,LL,PR,134750,40250,175000,5/21/2024,User1
300,14,1,LL,SP,127050,37950,165000,5/21/2024,User1
301,14,1,LL-S,PM,123200,36800,160000,5/21/2024,User1
302,14,1,LL-S,PR,154000,46000,200000,5/21/2024,User1
303,14,1,LL-S,SP,134750,40250,175000,5/21/2024,User1
304,14,1,FE,PM,1617000,483000,2100000,5/21/2024,User1
305,14,1,FE,PR,1925000,575000,2500000,5/21/2024,User1
306,14,1,FE,PR,1925000,575000,2500000,5/15/2024,User1
307,14,1,FE,SP,1732500,517500,2250000,5/15/2024,User1
308,14,1,FE,PM,1617000,483000,2100000,5/15/2024,User1
309,14,1,FE,PM,1578500,471500,2050000,2/26/2024,User1
310,14,1,FE,PR,1809500,540500,2350000,2/26/2024,User1
311,14,1,FE,SP,1655500,494500,2150000,2/26/2024,User1
312,14,1,GN,PM,485100,144900,630000,2/26/2024,User1
313,14,1,GN,PR,523600,156400,680000,2/26/2024,User1
314,14,1,LL,PM,111650,33350,145000,2/26/2024,User1
315,14,1,LL,PR,127050,37950,165000,2/26/2024,User1
316,14,1,LL,SP,119350,35650,155000,2/26/2024,User1
317,14,1,LL-S,PM,117040,34960,152000,2/26/2024,User1
318,14,1,LL-S,PR,130900,39100,170000,2/26/2024,User1
319,14,1,LL-S,SP,123200,36800,160000,2/26/2024,User1
320,14,1,GN,PM,515900,154100,670000,5/15/2024,User1
321,14,1,GN,PR,577500,172500,750000,5/15/2024,User1
322,14,1,LL,PM,119350,35650,155000,5/15/2024,User1
323,14,1,LL,PR,134750,40250,175000,5/15/2024,User1
324,14,1,LL,SP,127050,37950,165000,5/15/2024,User1
325,14,1,LL-S,PM,123200,36800,160000,5/15/2024,User1
326,14,1,LL-S,PR,154000,46000,200000,5/15/2024,User1
327,14,1,LL-S,SP,134750,40250,175000,5/15/2024,User1
328,14,1,LL,PR,134750,40250,175000,5/2/2024,User1
329,14,1,LL,SP,127050,37950,165000,5/2/2024,User1
330,14,1,LL-S,PM,123200,36800,160000,5/2/2024,User1
331,14,1,LL-S,PR,154000,46000,200000,5/2/2024,User1
332,14,1,LL-S,SP,134750,40250,175000,5/2/2024,User1
333,14,1,FE,PM,1617000,483000,2100000,5/2/2024,User1
334,14,1,FE,PR,1925000,575000,2500000,5/2/2024,User1
335,14,1,FE,SP,1732500,517500,2250000,5/2/2024,User1
336,14,1,GN,PM,515900,154100,670000,5/2/2024,User1
337,14,1,GN,PR,577500,172500,750000,5/2/2024,User1
338,14,1,LL,PM,119350,35650,155000,5/2/2024,User1
339,14,1,FE,PM,1617000,483000,2100000,5/27/2024,User1
340,14,1,FE,PR,1925000,575000,2500000,5/27/2024,User1
341,14,1,FE,SP,1732500,517500,2250000,5/27/2024,User1
342,14,1,GN,PM,515900,154100,670000,5/27/2024,User1
343,14,1,GN,PR,577500,172500,750000,5/27/2024,User1
344,14,1,LL,PM,119350,35650,155000,5/27/2024,User1
345,14,1,LL,PR,134750,40250,175000,5/27/2024,User1
346,14,1,LL,SP,127050,37950,165000,5/27/2024,User1
347,14,1,LL-S,PM,123200,36800,160000,5/27/2024,User1
348,14,1,LL-S,PR,154000,46000,200000,5/27/2024,User1
349,14,1,LL-S,SP,134750,40250,175000,5/27/2024,User1
350,14,1,LL,SP,127050,37950,165000,8/24/2024,User1
351,14,1,LL-S,PM,123200,36800,160000,8/24/2024,User1
352,14,1,LL-S,PR,154000,46000,200000,8/24/2024,User1
353,14,1,LL-S,SP,134750,40250,175000,8/24/2024,User1
354,14,1,FE,PM,1617000,483000,2100000,8/24/2024,User1
355,14,1,FE,PR,1925000,575000,2500000,8/24/2024,User1
356,14,1,FE,SP,1732500,517500,2250000,8/24/2024,User1
357,14,1,GN,PM,515900,154100,670000,8/24/2024,User1
358,14,1,GN,PR,577500,172500,750000,8/24/2024,User1
359,14,1,LL,PM,119350,35650,155000,8/24/2024,User1
360,14,1,LL,PR,134750,40250,175000,8/24/2024,User1
361,14,1,FE,PR,1925000,575000,2500000,6/29/2024,User1
362,14,1,FE,SP,1732500,517500,2250000,6/29/2024,User1
363,14,1,GN,PM,515900,154100,670000,6/29/2024,User1
364,14,1,GN,PR,577500,172500,750000,6/29/2024,User1
365,14,1,LL,PM,119350,35650,155000,6/29/2024,User1
366,14,1,LL,PR,134750,40250,175000,6/29/2024,User1
367,14,1,LL,SP,127050,37950,165000,6/29/2024,User1
368,14,1,FE,PM,1617000,483000,2100000,6/29/2024,User1
369,14,1,LL-S,PM,123200,36800,160000,6/29/2024,User1
370,14,1,LL-S,PR,154000,46000,200000,6/29/2024,User1
371,14,1,LL-S,SP,134750,40250,175000,6/29/2024,User1
372,14,1,FE,SP,1732500,517500,2250000,6/3/2024,User1
373,14,1,GN,PM,515900,154100,670000,6/3/2024,User1
374,14,1,GN,PR,577500,172500,750000,6/3/2024,User1
375,14,1,LL,PM,119350,35650,155000,6/3/2024,User1
376,14,1,LL,PR,134750,40250,175000,6/3/2024,User1
377,14,1,LL,SP,127050,37950,165000,6/3/2024,User1
378,14,1,LL-S,PM,123200,36800,160000,6/3/2024,User1
379,14,1,LL-S,PR,154000,46000,200000,6/3/2024,User1
380,14,1,LL-S,SP,134750,40250,175000,6/3/2024,User1
381,14,1,FE,PM,1617000,483000,2100000,6/3/2024,User1
382,14,1,FE,PR,1925000,575000,2500000,6/3/2024,User1
383,18,1,LL-S,PM,75000,25000,100000,1/27/2024,User1
384,18,1,LL-S,PM,75000,25000,100000,1/27/2024,User1
385,18,1,LL-S,PM,75000,25000,100000,1/27/2024,User1
386,18,1,LL-S,PM,75000,25000,100000,1/27/2024,User1
387,18,1,LL-S,PM,75000,25000,100000,1/27/2024,User1
388,18,1,LL-S,PM,75000,25000,100000,1/27/2024,User1
389,18,1,LL-S,PM,75000,25000,100000,1/27/2024,User1
390,18,1,LL-S,PM,75000,25000,100000,1/27/2024,User1
391,18,1,LL-S,PM,75000,25000,100000,1/27/2024,User1
392,18,1,LL,PR,87750,29250,117000,1/3/2024,User1
393,18,1,LL,PR,87750,29250,117000,1/3/2024,User1
394,18,1,LL,PR,87750,29250,117000,1/3/2024,User1
395,18,1,LL,PR,87750,29250,117000,1/3/2024,User1
396,18,1,LL,PR,87750,29250,117000,1/3/2024,User1
397,18,1,LL,PR,87750,29250,117000,1/3/2024,User1
398,18,1,LL,PR,87750,29250,117000,1/3/2024,User1
399,18,1,LL,PR,87750,29250,117000,1/3/2024,User1
400,18,1,LL,PR,87750,29250,117000,1/3/2024,User1
401,18,1,LL,PR,87750,29250,117000,1/3/2024,User1
402,18,1,LL,PR,87750,29250,117000,1/3/2024,User1
403,18,1,LL,PR,87750,29250,117000,1/3/2024,User1
404,18,1,LL,PR,87750,29250,117000,1/3/2024,User1
405,18,1,LL,PR,87750,29250,117000,1/3/2024,User1
406,18,1,LL,PR,87750,29250,117000,1/3/2024,User1
407,18,1,LL-S,PM,75000,25000,100000,1/3/2024,User1
408,18,1,LL-S,PM,75000,25000,100000,1/3/2024,User1
409,18,1,LL-S,PM,75000,25000,100000,1/3/2024,User1
410,18,1,LL-S,PM,75000,25000,100000,1/3/2024,User1
411,18,1,LL-S,PM,75000,25000,100000,1/3/2024,User1
412,18,1,LL-S,PM,75000,25000,100000,1/3/2024,User1
413,18,1,LL-S,PM,75000,25000,100000,1/3/2024,User1
414,18,1,LL-S,PM,75000,25000,100000,1/3/2024,User1
415,18,1,LL-S,PM,75000,25000,100000,1/3/2024,User1
416,18,1,LL-S,PM,75000,25000,100000,1/3/2024,User1
417,18,1,LL-S,PM,75000,25000,100000,1/3/2024,User1
418,18,1,LL-S,PM,75000,25000,100000,1/3/2024,User1
419,18,1,LL-S,PM,75000,25000,100000,1/3/2024,User1
420,18,1,LL-S,PM,75000,25000,100000,1/3/2024,User1
421,18,1,LL-S,PM,75000,25000,100000,1/3/2024,User1
422,18,1,LL-S,PM,75000,25000,100000,1/3/2024,User1
423,18,1,LL-S,PM,75000,25000,100000,1/3/2024,User1
424,18,1,LL-S,SP,80250,26750,107000,1/3/2024,User1
425,18,1,LL-S,SP,80250,26750,107000,1/3/2024,User1
426,18,1,LL-S,SP,80250,26750,107000,1/3/2024,User1
427,18,1,LL-S,SP,80250,26750,107000,1/3/2024,User1
428,18,1,LL-S,SP,80250,26750,107000,1/3/2024,User1
429,18,1,LL-S,SP,80250,26750,107000,1/3/2024,User1
430,18,1,LL-S,SP,80250,26750,107000,1/3/2024,User1
431,18,1,LL-S,SP,80250,26750,107000,1/3/2024,User1
432,18,1,LL-S,SP,80250,26750,107000,1/3/2024,User1
433,18,1,LL-S,SP,80250,26750,107000,1/3/2024,User1
434,18,1,LL-S,SP,80250,26750,107000,1/3/2024,User1
435,18,1,LL-S,SP,80250,26750,107000,1/3/2024,User1
436,18,1,LL-S,SP,80250,26750,107000,1/3/2024,User1
437,18,1,LL-S,SP,80250,26750,107000,1/3/2024,User1
438,18,1,LL-S,SP,80250,26750,107000,1/3/2024,User1
439,18,1,LL-S,SP,80250,26750,107000,1/3/2024,User1
440,18,1,LL-S,PR,87750,29250,117000,1/3/2024,User1
441,18,1,LL-S,PR,87750,29250,117000,1/3/2024,User1
442,18,1,LL-S,PR,87750,29250,117000,1/3/2024,User1
443,18,1,LL-S,PR,87750,29250,117000,1/3/2024,User1
444,18,1,LL-S,PR,87750,29250,117000,1/3/2024,User1
445,18,1,LL-S,PR,87750,29250,117000,1/3/2024,User1
446,18,1,LL-S,PR,87750,29250,117000,1/3/2024,User1
447,18,1,LL-S,PR,87750,29250,117000,1/3/2024,User1
448,18,1,LL-S,PR,87750,29250,117000,1/3/2024,User1
449,18,1,LL-S,PR,87750,29250,117000,1/3/2024,User1
450,18,1,LL-S,PR,87750,29250,117000,1/3/2024,User1
451,18,1,LL-S,PR,87750,29250,117000,1/3/2024,User1
452,18,1,LL-S,PR,87750,29250,117000,1/3/2024,User1
453,18,1,LL-S,PR,87750,29250,117000,1/3/2024,User1
454,18,1,LL-S,PR,87750,29250,117000,1/3/2024,User1
455,18,1,FE,FE12-PM,1125000,375000,1500000,1/3/2024,User1
456,18,1,FE,FE12-PM,1125000,375000,1500000,1/3/2024,User1
457,18,1,FE,FE12-PM,1125000,375000,1500000,1/3/2024,User1
458,18,1,FE,FE12-PM,1125000,375000,1500000,1/3/2024,User1
459,18,1,FE,FE12-PM,1125000,375000,1500000,1/3/2024,User1
460,18,1,FE,FE12-PM,1125000,375000,1500000,1/3/2024,User1
461,18,1,FE,FE12-PM,1125000,375000,1500000,1/3/2024,User1
462,18,1,FE,FE12-PM,1125000,375000,1500000,1/3/2024,User1
463,18,1,FE,FE12-PM,1125000,375000,1500000,1/3/2024,User1
464,18,1,FE,FE12-PM,1125000,375000,1500000,1/3/2024,User1
465,18,1,FE,FE12-PM,1125000,375000,1500000,1/3/2024,User1
466,18,1,FE,FE12-PM,1125000,375000,1500000,1/3/2024,User1
467,18,1,FE,FE12-PM,1125000,375000,1500000,1/3/2024,User1
468,18,1,FE,FE12-PM,1125000,375000,1500000,1/3/2024,User1
469,18,1,FE,FE19-PM,1781250,593750,2375000,1/3/2024,User1
470,18,1,FE,FE19-PM,1781250,593750,2375000,1/3/2024,User1
471,18,1,FE,FE19-PM,1781250,593750,2375000,1/3/2024,User1
472,18,1,FE,FE19-PM,1781250,593750,2375000,1/3/2024,User1
473,18,1,FE,FE19-PM,1781250,593750,2375000,1/3/2024,User1
474,18,1,FE,FE19-PM,1781250,593750,2375000,1/3/2024,User1
475,18,1,FE,FE19-PM,1781250,593750,2375000,1/3/2024,User1
476,18,1,FE,FE19-PM,1781250,593750,2375000,1/3/2024,User1
477,18,1,FE,FE19-PM,1781250,593750,2375000,1/3/2024,User1
478,18,1,FE,FE19-PM,1781250,593750,2375000,1/3/2024,User1
479,18,1,FE,FE19-PM,1781250,593750,2375000,1/3/2024,User1
480,18,1,FE,FE19-PM,1781250,593750,2375000,1/3/2024,User1
481,18,1,FE,FE19-PM,1781250,593750,2375000,1/3/2024,User1
482,18,1,FE,FE19-PM,1781250,593750,2375000,1/3/2024,User1
483,18,1,FE,FE19-PM,1781250,593750,2375000,1/3/2024,User1
484,18,1,LL,PM,75000,25000,100000,1/3/2024,User1
485,18,1,LL,PM,75000,25000,100000,1/3/2024,User1
486,18,1,LL,PM,75000,25000,100000,1/3/2024,User1
487,18,1,LL,PM,75000,25000,100000,1/3/2024,User1
488,18,1,LL,PM,75000,25000,100000,1/3/2024,User1
489,18,1,LL,PM,75000,25000,100000,1/3/2024,User1
490,18,1,LL,PM,75000,25000,100000,1/3/2024,User1
491,18,1,LL,PM,75000,25000,100000,1/3/2024,User1
492,18,1,LL,PM,75000,25000,100000,1/3/2024,User1
493,18,1,LL,PM,75000,25000,100000,1/3/2024,User1
494,18,1,LL,PM,75000,25000,100000,1/3/2024,User1
495,18,1,LL,PM,75000,25000,100000,1/3/2024,User1
496,18,1,LL,PM,75000,25000,100000,1/3/2024,User1
497,18,1,LL,PM,75000,25000,100000,1/3/2024,User1
498,18,1,LL,PM,75000,25000,100000,1/3/2024,User1
499,18,1,LL,SP,80250,26750,107000,1/3/2024,User1
500,18,1,LL,SP,80250,26750,107000,1/3/2024,User1
501,18,1,LL,SP,80250,26750,107000,1/3/2024,User1
502,18,1,LL,SP,80250,26750,107000,1/3/2024,User1
503,18,1,LL,SP,80250,26750,107000,1/3/2024,User1
504,18,1,LL,SP,80250,26750,107000,1/3/2024,User1
505,18,1,LL,SP,80250,26750,107000,1/3/2024,User1
506,18,1,LL,SP,80250,26750,107000,1/3/2024,User1
507,18,1,LL,SP,80250,26750,107000,1/3/2024,User1
508,18,1,LL,SP,80250,26750,107000,1/3/2024,User1
509,18,1,LL,SP,80250,26750,107000,1/3/2024,User1
510,18,1,LL,SP,80250,26750,107000,1/3/2024,User1
511,18,1,LL,SP,80250,26750,107000,1/3/2024,User1
512,18,1,LL,SP,80250,26750,107000,1/3/2024,User1
513,18,1,LL,SP,80250,26750,107000,1/3/2024,User1
514,18,1,LL,SP,80250,26750,107000,1/3/2024,User1
515,18,1,LL,PR,87750,29250,117000,1/3/2024,User1
516,18,1,LL-S,PM,75000,25000,100000,1/27/2024,User1
517,18,1,LL-S,PM,75000,25000,100000,1/27/2024,User1
518,18,1,LL-S,PM,75000,25000,100000,1/27/2024,User1
519,18,1,LL-S,SP,80250,26750,107000,1/27/2024,User1
520,18,1,LL-S,SP,80250,26750,107000,1/27/2024,User1
521,18,1,LL-S,SP,80250,26750,107000,1/27/2024,User1
522,18,1,LL-S,SP,80250,26750,107000,1/27/2024,User1
523,18,1,LL-S,SP,80250,26750,107000,1/27/2024,User1
524,18,1,LL-S,SP,80250,26750,107000,1/27/2024,User1
525,18,1,LL-S,SP,80250,26750,107000,1/27/2024,User1
526,18,1,LL-S,SP,80250,26750,107000,1/27/2024,User1
527,18,1,LL-S,SP,80250,26750,107000,1/27/2024,User1
528,18,1,LL-S,SP,80250,26750,107000,1/27/2024,User1
529,18,1,LL-S,SP,80250,26750,107000,1/27/2024,User1
530,18,1,LL-S,SP,80250,26750,107000,1/27/2024,User1
531,18,1,LL-S,SP,80250,26750,107000,1/27/2024,User1
532,18,1,LL-S,SP,80250,26750,107000,1/27/2024,User1
533,18,1,LL-S,SP,80250,26750,107000,1/27/2024,User1
534,18,1,LL-S,SP,80250,26750,107000,1/27/2024,User1
535,18,1,LL-S,PR,87750,29250,117000,1/27/2024,User1
536,18,1,LL-S,PR,87750,29250,117000,1/27/2024,User1
537,18,1,LL-S,PR,87750,29250,117000,1/27/2024,User1
538,18,1,LL-S,PR,87750,29250,117000,1/27/2024,User1
539,18,1,LL-S,PR,87750,29250,117000,1/27/2024,User1
540,18,1,LL-S,PR,87750,29250,117000,1/27/2024,User1
541,18,1,LL-S,PR,87750,29250,117000,1/27/2024,User1
542,18,1,LL-S,PR,87750,29250,117000,1/27/2024,User1
543,18,1,LL-S,PR,87750,29250,117000,1/27/2024,User1
544,18,1,LL,PR,87750,29250,117000,1/27/2024,User1
545,18,1,LL,PR,87750,29250,117000,1/27/2024,User1
546,18,1,LL,PR,87750,29250,117000,1/27/2024,User1
547,18,1,LL,PR,87750,29250,117000,1/27/2024,User1
548,18,1,LL,PR,87750,29250,117000,1/27/2024,User1
549,18,1,LL,PR,87750,29250,117000,1/27/2024,User1
550,18,1,LL,PR,87750,29250,117000,1/27/2024,User1
551,18,1,LL,PR,87750,29250,117000,1/27/2024,User1
552,18,1,LL,PR,87750,29250,117000,1/27/2024,User1
553,18,1,LL,PR,87750,29250,117000,1/27/2024,User1
554,18,1,LL,PR,87750,29250,117000,1/27/2024,User1
555,18,1,LL,PR,87750,29250,117000,1/27/2024,User1
556,18,1,LL,PR,87750,29250,117000,1/27/2024,User1
557,18,1,LL,PR,87750,29250,117000,1/27/2024,User1
558,18,1,LL,PR,87750,29250,117000,1/27/2024,User1
559,18,1,LL-S,PM,75000,25000,100000,1/27/2024,User1
560,18,1,LL-S,PM,75000,25000,100000,1/27/2024,User1
561,18,1,LL-S,PM,75000,25000,100000,1/27/2024,User1
562,18,1,LL-S,PM,75000,25000,100000,1/27/2024,User1
563,18,1,LL-S,PM,75000,25000,100000,1/27/2024,User1
564,18,1,LL-S,PR,87750,29250,117000,1/27/2024,User1
565,18,1,LL-S,PR,87750,29250,117000,1/27/2024,User1
566,18,1,LL-S,PR,87750,29250,117000,1/27/2024,User1
567,18,1,LL-S,PR,87750,29250,117000,1/27/2024,User1
568,18,1,LL-S,PR,87750,29250,117000,1/27/2024,User1
569,18,1,LL-S,PR,87750,29250,117000,1/27/2024,User1
570,18,1,FE,FE12-PM,1125000,375000,1500000,1/27/2024,User1
571,18,1,FE,FE12-PM,1125000,375000,1500000,1/27/2024,User1
572,18,1,FE,FE12-PM,1125000,375000,1500000,1/27/2024,User1
573,18,1,FE,FE12-PM,1125000,375000,1500000,1/27/2024,User1
574,18,1,FE,FE12-PM,1125000,375000,1500000,1/27/2024,User1
575,18,1,FE,FE12-PM,1125000,375000,1500000,1/27/2024,User1
576,18,1,FE,FE12-PM,1125000,375000,1500000,1/27/2024,User1
577,18,1,FE,FE12-PM,1125000,375000,1500000,1/27/2024,User1
578,18,1,FE,FE12-PM,1125000,375000,1500000,1/27/2024,User1
579,18,1,FE,FE12-PM,1125000,375000,1500000,1/27/2024,User1
580,18,1,FE,FE12-PM,1125000,375000,1500000,1/27/2024,User1
581,18,1,FE,FE12-PM,1125000,375000,1500000,1/27/2024,User1
582,18,1,FE,FE12-PM,1125000,375000,1500000,1/27/2024,User1
583,18,1,FE,FE12-PM,1125000,375000,1500000,1/27/2024,User1
584,18,1,FE,FE19-PM,1781250,593750,2375000,1/27/2024,User1
585,18,1,FE,FE19-PM,1781250,593750,2375000,1/27/2024,User1
586,18,1,FE,FE19-PM,1781250,593750,2375000,1/27/2024,User1
587,18,1,FE,FE19-PM,1781250,593750,2375000,1/27/2024,User1
588,18,1,FE,FE19-PM,1781250,593750,2375000,1/27/2024,User1
589,18,1,FE,FE19-PM,1781250,593750,2375000,1/27/2024,User1
590,18,1,FE,FE19-PM,1781250,593750,2375000,1/27/2024,User1
591,18,1,LL,PM,75000,25000,100000,1/27/2024,User1
592,18,1,LL,PM,75000,25000,100000,1/27/2024,User1
593,18,1,LL,PM,75000,25000,100000,1/27/2024,User1
594,18,1,LL,PM,75000,25000,100000,1/27/2024,User1
595,18,1,LL,PM,75000,25000,100000,1/27/2024,User1
596,18,1,LL,PM,75000,25000,100000,1/27/2024,User1
597,18,1,LL,PM,75000,25000,100000,1/27/2024,User1
598,18,1,LL,PM,75000,25000,100000,1/27/2024,User1
599,18,1,LL,PM,75000,25000,100000,1/27/2024,User1
600,18,1,LL,PM,75000,25000,100000,1/27/2024,User1
601,18,1,LL,PM,75000,25000,100000,1/27/2024,User1
602,18,1,LL,PM,75000,25000,100000,1/27/2024,User1
603,18,1,LL,PM,75000,25000,100000,1/27/2024,User1
604,18,1,LL,PM,75000,25000,100000,1/27/2024,User1
605,18,1,LL,PM,75000,25000,100000,1/27/2024,User1
606,18,1,LL,SP,80250,26750,107000,1/27/2024,User1
607,18,1,LL,SP,80250,26750,107000,1/27/2024,User1
608,18,1,LL,SP,80250,26750,107000,1/27/2024,User1
609,18,1,LL,SP,80250,26750,107000,1/27/2024,User1
610,18,1,LL,SP,80250,26750,107000,1/27/2024,User1
611,18,1,LL,SP,80250,26750,107000,1/27/2024,User1
612,18,1,LL,SP,80250,26750,107000,1/27/2024,User1
613,18,1,LL,SP,80250,26750,107000,1/27/2024,User1
614,18,1,LL,SP,80250,26750,107000,1/27/2024,User1
615,18,1,LL,SP,80250,26750,107000,1/27/2024,User1
616,18,1,LL,SP,80250,26750,107000,1/27/2024,User1
617,18,1,LL,SP,80250,26750,107000,1/27/2024,User1
618,18,1,LL,SP,80250,26750,107000,1/27/2024,User1
619,18,1,LL,SP,80250,26750,107000,1/27/2024,User1
620,18,1,LL,SP,80250,26750,107000,1/27/2024,User1
621,18,1,LL,SP,80250,26750,107000,1/27/2024,User1
622,18,1,LL,PR,87750,29250,117000,1/27/2024,User1
623,18,1,FE,FE19-PM,1781250,593750,2375000,1/27/2024,User1
624,18,1,FE,FE19-PM,1781250,593750,2375000,1/27/2024,User1
625,18,1,FE,FE19-PM,1781250,593750,2375000,1/27/2024,User1
626,18,1,FE,FE19-PM,1781250,593750,2375000,1/27/2024,User1
627,18,1,FE,FE19-PM,1781250,593750,2375000,1/27/2024,User1
628,18,1,FE,FE19-PM,1781250,593750,2375000,1/27/2024,User1
629,18,1,FE,FE19-PM,1781250,593750,2375000,1/27/2024,User1
630,18,1,FE,FE19-PM,1781250,593750,2375000,1/27/2024,User1
631,18,1,LL,PM,75000,25000,100000,1/31/2024,User1
632,18,1,LL,PM,75000,25000,100000,1/31/2024,User1
633,18,1,LL,PM,75000,25000,100000,1/31/2024,User1
634,18,1,LL,PM,75000,25000,100000,1/31/2024,User1
635,18,1,LL,PM,75000,25000,100000,1/31/2024,User1
636,18,1,LL,PM,75000,25000,100000,1/31/2024,User1
637,18,1,LL,PM,75000,25000,100000,1/31/2024,User1
638,18,1,LL,PM,75000,25000,100000,1/31/2024,User1
639,18,1,LL,PM,75000,25000,100000,1/31/2024,User1
640,18,1,LL,PM,75000,25000,100000,1/31/2024,User1
641,18,1,LL,PM,75000,25000,100000,1/31/2024,User1
642,18,1,LL,PM,75000,25000,100000,1/31/2024,User1
643,18,1,LL,PM,75000,25000,100000,1/31/2024,User1
644,18,1,LL,PM,75000,25000,100000,1/31/2024,User1
645,18,1,LL,PM,75000,25000,100000,1/31/2024,User1
646,18,1,LL,SP,80250,26750,107000,1/31/2024,User1
647,18,1,LL,SP,80250,26750,107000,1/31/2024,User1
648,18,1,LL,SP,80250,26750,107000,1/31/2024,User1
649,18,1,LL,SP,80250,26750,107000,1/31/2024,User1
650,18,1,LL,SP,80250,26750,107000,1/31/2024,User1
651,18,1,LL,SP,80250,26750,107000,1/31/2024,User1
652,18,1,LL,SP,80250,26750,107000,1/31/2024,User1
653,18,1,LL,SP,80250,26750,107000,1/31/2024,User1
654,18,1,LL,SP,80250,26750,107000,1/31/2024,User1
655,18,1,LL,SP,80250,26750,107000,1/31/2024,User1
656,18,1,LL,SP,80250,26750,107000,1/31/2024,User1
657,18,1,LL,SP,80250,26750,107000,1/31/2024,User1
658,18,1,LL,SP,80250,26750,107000,1/31/2024,User1
659,18,1,LL,SP,80250,26750,107000,1/31/2024,User1
660,18,1,LL,SP,80250,26750,107000,1/31/2024,User1
661,18,1,LL,SP,80250,26750,107000,1/31/2024,User1
662,18,1,LL,PR,87750,29250,117000,1/31/2024,User1
663,18,1,LL,PR,87750,29250,117000,1/31/2024,User1
664,18,1,LL,PR,87750,29250,117000,1/31/2024,User1
665,18,1,LL,PR,87750,29250,117000,1/31/2024,User1
666,18,1,LL,PR,87750,29250,117000,1/31/2024,User1
667,18,1,LL,PR,87750,29250,117000,1/31/2024,User1
668,18,1,LL,PR,87750,29250,117000,1/31/2024,User1
669,18,1,LL,PR,87750,29250,117000,1/31/2024,User1
670,18,1,LL,PR,87750,29250,117000,1/31/2024,User1
671,18,1,LL,PR,87750,29250,117000,1/31/2024,User1
672,18,1,LL,PR,87750,29250,117000,1/31/2024,User1
673,18,1,LL,PR,87750,29250,117000,1/31/2024,User1
674,18,1,LL,PR,87750,29250,117000,1/31/2024,User1
675,18,1,LL,PR,87750,29250,117000,1/31/2024,User1
676,18,1,LL,PR,87750,29250,117000,1/31/2024,User1
677,18,1,LL,PR,87750,29250,117000,1/31/2024,User1
678,18,1,LL-S,PM,75000,25000,100000,1/31/2024,User1
679,18,1,LL-S,PM,75000,25000,100000,1/31/2024,User1
680,18,1,LL-S,PM,75000,25000,100000,1/31/2024,User1
681,18,1,LL-S,PM,75000,25000,100000,1/31/2024,User1
682,18,1,LL-S,PM,75000,25000,100000,1/31/2024,User1
683,18,1,LL-S,PM,75000,25000,100000,1/31/2024,User1
684,18,1,LL-S,PM,75000,25000,100000,1/31/2024,User1
685,18,1,LL-S,PM,75000,25000,100000,1/31/2024,User1
686,18,1,LL-S,PM,75000,25000,100000,1/31/2024,User1
687,18,1,LL-S,PM,75000,25000,100000,1/31/2024,User1
688,18,1,LL-S,PM,75000,25000,100000,1/31/2024,User1
689,18,1,LL-S,PM,75000,25000,100000,1/31/2024,User1
690,18,1,LL-S,PM,75000,25000,100000,1/31/2024,User1
691,18,1,LL-S,PM,75000,25000,100000,1/31/2024,User1
692,18,1,LL-S,PM,75000,25000,100000,1/31/2024,User1
693,18,1,LL-S,PM,75000,25000,100000,1/31/2024,User1
694,18,1,LL-S,PM,75000,25000,100000,1/31/2024,User1
695,18,1,LL-S,SP,80250,26750,107000,1/31/2024,User1
696,18,1,LL-S,SP,80250,26750,107000,1/31/2024,User1
697,18,1,LL-S,SP,80250,26750,107000,1/31/2024,User1
698,18,1,LL-S,SP,80250,26750,107000,1/31/2024,User1
699,18,1,LL-S,SP,80250,26750,107000,1/31/2024,User1
700,18,1,LL-S,SP,80250,26750,107000,1/31/2024,User1
701,18,1,LL-S,SP,80250,26750,107000,1/31/2024,User1
702,18,1,LL-S,SP,80250,26750,107000,1/31/2024,User1
703,18,1,LL-S,SP,80250,26750,107000,1/31/2024,User1
704,18,1,LL-S,SP,80250,26750,107000,1/31/2024,User1
705,18,1,LL-S,SP,80250,26750,107000,1/31/2024,User1
706,18,1,LL-S,SP,80250,26750,107000,1/31/2024,User1
707,18,1,LL-S,SP,80250,26750,107000,1/31/2024,User1
708,18,1,LL-S,SP,80250,26750,107000,1/31/2024,User1
709,18,1,LL-S,SP,80250,26750,107000,1/31/2024,User1
710,18,1,LL-S,SP,80250,26750,107000,1/31/2024,User1
711,18,1,LL-S,PR,87750,29250,117000,1/31/2024,User1
712,18,1,LL-S,PR,87750,29250,117000,1/31/2024,User1
713,18,1,LL-S,PR,87750,29250,117000,1/31/2024,User1
714,18,1,LL-S,PR,87750,29250,117000,1/31/2024,User1
715,18,1,LL-S,PR,87750,29250,117000,1/31/2024,User1
716,18,1,LL-S,PR,87750,29250,117000,1/31/2024,User1
717,18,1,LL-S,PR,87750,29250,117000,1/31/2024,User1
718,18,1,LL-S,PR,87750,29250,117000,1/31/2024,User1
719,18,1,LL-S,PR,87750,29250,117000,1/31/2024,User1
720,18,1,LL-S,PR,87750,29250,117000,1/31/2024,User1
721,18,1,LL-S,PR,87750,29250,117000,1/31/2024,User1
722,18,1,LL-S,PR,87750,29250,117000,1/31/2024,User1
723,18,1,LL-S,PR,87750,29250,117000,1/31/2024,User1
724,18,1,LL-S,PR,87750,29250,117000,1/31/2024,User1
725,18,1,LL-S,PR,87750,29250,117000,1/31/2024,User1
726,18,1,FE,FE12-PM,1125000,375000,1500000,1/31/2024,User1
727,18,1,FE,FE12-PM,1125000,375000,1500000,1/31/2024,User1
728,18,1,FE,FE12-PM,1125000,375000,1500000,1/31/2024,User1
729,18,1,FE,FE12-PM,1125000,375000,1500000,1/31/2024,User1
730,18,1,FE,FE12-PM,1125000,375000,1500000,1/31/2024,User1
731,18,1,FE,FE12-PM,1125000,375000,1500000,1/31/2024,User1
732,18,1,FE,FE12-PM,1125000,375000,1500000,1/31/2024,User1
733,18,1,FE,FE12-PM,1125000,375000,1500000,1/31/2024,User1
734,18,1,FE,FE12-PM,1125000,375000,1500000,1/31/2024,User1
735,18,1,FE,FE12-PM,1125000,375000,1500000,1/31/2024,User1
736,18,1,FE,FE12-PM,1125000,375000,1500000,1/31/2024,User1
737,18,1,FE,FE12-PM,1125000,375000,1500000,1/31/2024,User1
738,18,1,FE,FE12-PM,1125000,375000,1500000,1/31/2024,User1
739,18,1,FE,FE12-PM,1125000,375000,1500000,1/31/2024,User1
740,18,1,FE,FE19-PM,1781250,593750,2375000,1/31/2024,User1
741,18,1,FE,FE19-PM,1781250,593750,2375000,1/31/2024,User1
742,18,1,FE,FE19-PM,1781250,593750,2375000,1/31/2024,User1
743,18,1,FE,FE19-PM,1781250,593750,2375000,1/31/2024,User1
744,18,1,FE,FE19-PM,1781250,593750,2375000,1/31/2024,User1
745,18,1,FE,FE19-PM,1781250,593750,2375000,1/31/2024,User1
746,18,1,FE,FE19-PM,1781250,593750,2375000,1/31/2024,User1
747,18,1,FE,FE19-PM,1781250,593750,2375000,1/31/2024,User1
748,18,1,FE,FE19-PM,1781250,593750,2375000,1/31/2024,User1
749,18,1,FE,FE19-PM,1781250,593750,2375000,1/31/2024,User1
750,18,1,FE,FE19-PM,1781250,593750,2375000,1/31/2024,User1
751,18,1,FE,FE19-PM,1781250,593750,2375000,1/31/2024,User1
752,18,1,FE,FE19-PM,1781250,593750,2375000,1/31/2024,User1
753,18,1,FE,FE19-PM,1781250,593750,2375000,1/31/2024,User1
754,18,1,FE,FE19-PM,1781250,593750,2375000,1/31/2024,User1
755,18,1,LL,PM,75000,25000,100000,3/8/2024,User1
756,18,1,LL,PM,75000,25000,100000,3/8/2024,User1
757,18,1,LL,PM,75000,25000,100000,3/8/2024,User1
758,18,1,LL,PM,75000,25000,100000,3/8/2024,User1
759,18,1,LL,PM,75000,25000,100000,3/8/2024,User1
760,18,1,LL,PM,75000,25000,100000,3/8/2024,User1
761,18,1,LL,PM,75000,25000,100000,3/8/2024,User1
762,18,1,LL,PM,75000,25000,100000,3/8/2024,User1
763,18,1,LL,PM,75000,25000,100000,3/8/2024,User1
764,18,1,LL,PM,75000,25000,100000,3/8/2024,User1
765,18,1,LL,PM,75000,25000,100000,3/8/2024,User1
766,18,1,LL,PM,75000,25000,100000,3/8/2024,User1
767,18,1,LL,PM,75000,25000,100000,3/8/2024,User1
768,18,1,LL,PM,75000,25000,100000,3/8/2024,User1
769,18,1,LL,PM,75000,25000,100000,3/8/2024,User1
770,18,1,LL,SP,80250,26750,107000,3/8/2024,User1
771,18,1,LL,SP,80250,26750,107000,3/8/2024,User1
772,18,1,LL,SP,80250,26750,107000,3/8/2024,User1
773,18,1,LL,SP,80250,26750,107000,3/8/2024,User1
774,18,1,LL,SP,80250,26750,107000,3/8/2024,User1
775,18,1,LL,SP,80250,26750,107000,3/8/2024,User1
776,18,1,LL,SP,80250,26750,107000,3/8/2024,User1
777,18,1,LL,SP,80250,26750,107000,3/8/2024,User1
778,18,1,LL,SP,80250,26750,107000,3/8/2024,User1
779,18,1,LL,SP,80250,26750,107000,3/8/2024,User1
780,18,1,LL,SP,80250,26750,107000,3/8/2024,User1
781,18,1,LL,SP,80250,26750,107000,3/8/2024,User1
782,18,1,LL,SP,80250,26750,107000,3/8/2024,User1
783,18,1,LL,SP,80250,26750,107000,3/8/2024,User1
784,18,1,LL,SP,80250,26750,107000,3/8/2024,User1
785,18,1,LL,PR,87750,29250,117000,3/8/2024,User1
786,18,1,LL,PR,87750,29250,117000,3/8/2024,User1
787,18,1,LL,PR,87750,29250,117000,3/8/2024,User1
788,18,1,LL,PR,87750,29250,117000,3/8/2024,User1
789,18,1,LL,PR,87750,29250,117000,3/8/2024,User1
790,18,1,LL,PR,87750,29250,117000,3/8/2024,User1
791,18,1,LL,PR,87750,29250,117000,3/8/2024,User1
792,18,1,LL,PR,87750,29250,117000,3/8/2024,User1
793,18,1,LL,PR,87750,29250,117000,3/8/2024,User1
794,18,1,LL,PR,87750,29250,117000,3/8/2024,User1
795,18,1,LL,PR,87750,29250,117000,3/8/2024,User1
796,18,1,LL,PR,87750,29250,117000,3/8/2024,User1
797,18,1,LL,PR,87750,29250,117000,3/8/2024,User1
798,18,1,LL,PR,87750,29250,117000,3/8/2024,User1
799,18,1,LL,PR,87750,29250,117000,3/8/2024,User1
800,18,1,LL,PR,87750,29250,117000,3/8/2024,User1
801,18,1,LL-S,PM,75000,25000,100000,3/8/2024,User1
802,18,1,LL-S,PM,75000,25000,100000,3/8/2024,User1
803,18,1,LL-S,PM,75000,25000,100000,3/8/2024,User1
804,18,1,LL-S,PM,75000,25000,100000,3/8/2024,User1
805,18,1,LL-S,PM,75000,25000,100000,3/8/2024,User1
806,18,1,LL-S,PM,75000,25000,100000,3/8/2024,User1
807,18,1,LL-S,PM,75000,25000,100000,3/8/2024,User1
808,18,1,LL-S,PM,75000,25000,100000,3/8/2024,User1
809,18,1,LL-S,PM,75000,25000,100000,3/8/2024,User1
810,18,1,LL-S,PM,75000,25000,100000,3/8/2024,User1
811,18,1,LL-S,PM,75000,25000,100000,3/8/2024,User1
812,18,1,LL-S,PM,75000,25000,100000,3/8/2024,User1
813,18,1,LL-S,PM,75000,25000,100000,3/8/2024,User1
814,18,1,LL-S,PM,75000,25000,100000,3/8/2024,User1
815,18,1,LL-S,PM,75000,25000,100000,3/8/2024,User1
816,18,1,LL-S,SP,80250,26750,107000,3/8/2024,User1
817,18,1,LL-S,SP,80250,26750,107000,3/8/2024,User1
818,18,1,LL-S,SP,80250,26750,107000,3/8/2024,User1
819,18,1,LL-S,SP,80250,26750,107000,3/8/2024,User1
820,18,1,LL-S,SP,80250,26750,107000,3/8/2024,User1
821,18,1,LL-S,SP,80250,26750,107000,3/8/2024,User1
822,18,1,LL-S,SP,80250,26750,107000,3/8/2024,User1
823,18,1,LL-S,SP,80250,26750,107000,3/8/2024,User1
824,18,1,LL-S,SP,80250,26750,107000,3/8/2024,User1
825,18,1,LL-S,SP,80250,26750,107000,3/8/2024,User1
826,18,1,LL-S,SP,80250,26750,107000,3/8/2024,User1
827,18,1,LL-S,SP,80250,26750,107000,3/8/2024,User1
828,18,1,LL-S,SP,80250,26750,107000,3/8/2024,User1
829,18,1,LL-S,SP,80250,26750,107000,3/8/2024,User1
830,18,1,LL-S,SP,80250,26750,107000,3/8/2024,User1
831,18,1,LL-S,PR,87750,29250,117000,3/8/2024,User1
832,18,1,LL-S,PR,87750,29250,117000,3/8/2024,User1
833,18,1,LL-S,PR,87750,29250,117000,3/8/2024,User1
834,18,1,LL-S,PR,87750,29250,117000,3/8/2024,User1
835,18,1,LL-S,PR,87750,29250,117000,3/8/2024,User1
836,18,1,LL-S,PR,87750,29250,117000,3/8/2024,User1
837,18,1,LL-S,PR,87750,29250,117000,3/8/2024,User1
838,18,1,LL-S,PR,87750,29250,117000,3/8/2024,User1
839,18,1,LL-S,PR,87750,29250,117000,3/8/2024,User1
840,18,1,LL-S,PR,87750,29250,117000,3/8/2024,User1
841,18,1,LL-S,PR,87750,29250,117000,3/8/2024,User1
842,18,1,LL-S,PR,87750,29250,117000,3/8/2024,User1
843,18,1,LL-S,PR,87750,29250,117000,3/8/2024,User1
844,18,1,LL-S,PR,87750,29250,117000,3/8/2024,User1
845,18,1,LL-S,PR,87750,29250,117000,3/8/2024,User1
846,18,1,LL-S,PR,87750,29250,117000,3/8/2024,User1
847,18,1,FE,FE12-PM,1125000,375000,1500000,3/8/2024,User1
848,18,1,FE,FE12-PM,1125000,375000,1500000,3/8/2024,User1
849,18,1,FE,FE12-PM,1125000,375000,1500000,3/8/2024,User1
850,18,1,FE,FE12-PM,1125000,375000,1500000,3/8/2024,User1
851,18,1,FE,FE12-PM,1125000,375000,1500000,3/8/2024,User1
852,18,1,FE,FE12-PM,1125000,375000,1500000,3/8/2024,User1
853,18,1,FE,FE12-PM,1125000,375000,1500000,3/8/2024,User1
854,18,1,FE,FE12-PM,1125000,375000,1500000,3/8/2024,User1
855,18,1,FE,FE12-PM,1125000,375000,1500000,3/8/2024,User1
856,18,1,FE,FE12-PM,1125000,375000,1500000,3/8/2024,User1
857,18,1,FE,FE12-PM,1125000,375000,1500000,3/8/2024,User1
858,18,1,FE,FE12-PM,1125000,375000,1500000,3/8/2024,User1
859,18,1,FE,FE12-PM,1125000,375000,1500000,3/8/2024,User1
860,18,1,FE,FE12-PM,1125000,375000,1500000,3/8/2024,User1
861,18,1,FE,FE12-PM,1125000,375000,1500000,3/8/2024,User1
862,18,1,FE,FE19-PM,1781250,593750,2375000,3/8/2024,User1
863,18,1,FE,FE19-PM,1781250,593750,2375000,3/8/2024,User1
864,18,1,FE,FE19-PM,1781250,593750,2375000,3/8/2024,User1
865,18,1,FE,FE19-PM,1781250,593750,2375000,3/8/2024,User1
866,18,1,FE,FE19-PM,1781250,593750,2375000,3/8/2024,User1
867,18,1,FE,FE19-PM,1781250,593750,2375000,3/8/2024,User1
868,18,1,FE,FE19-PM,1781250,593750,2375000,3/8/2024,User1
869,18,1,FE,FE19-PM,1781250,593750,2375000,3/8/2024,User1
870,18,1,FE,FE19-PM,1781250,593750,2375000,3/8/2024,User1
871,18,1,FE,FE19-PM,1781250,593750,2375000,3/8/2024,User1
872,18,1,FE,FE19-PM,1781250,593750,2375000,3/8/2024,User1
873,18,1,FE,FE19-PM,1781250,593750,2375000,3/8/2024,User1
874,18,1,FE,FE19-PM,1781250,593750,2375000,3/8/2024,User1
875,18,1,FE,FE19-PM,1781250,593750,2375000,3/8/2024,User1
876,18,1,FE,FE19-PM,1781250,593750,2375000,3/8/2024,User1
877,18,1,LL,SP,86250,28750,115000,7/2/2024,User1
878,18,1,LL,SP,86250,28750,115000,7/2/2024,User1
879,18,1,LL,PR,94500,31500,126000,7/2/2024,User1
880,18,1,LL,PR,94500,31500,126000,7/2/2024,User1
881,18,1,LL,PR,94500,31500,126000,7/2/2024,User1
882,18,1,LL,PR,94500,31500,126000,7/2/2024,User1
883,18,1,LL,PR,94500,31500,126000,7/2/2024,User1
884,18,1,LL,PR,94500,31500,126000,7/2/2024,User1
885,18,1,LL,PR,94500,31500,126000,7/2/2024,User1
886,18,1,LL,PR,94500,31500,126000,7/2/2024,User1
887,18,1,LL,PR,94500,31500,126000,7/2/2024,User1
888,18,1,LL,PR,94500,31500,126000,7/2/2024,User1
889,18,1,LL,PR,94500,31500,126000,7/2/2024,User1
890,18,1,LL,PR,94500,31500,126000,7/2/2024,User1
891,18,1,LL,PR,94500,31500,126000,7/2/2024,User1
892,18,1,LL,PR,94500,31500,126000,7/2/2024,User1
893,18,1,LL,PR,94500,31500,126000,7/2/2024,User1
894,18,1,LL,PR,94500,31500,126000,7/2/2024,User1
895,18,1,LL,PR,94500,31500,126000,7/2/2024,User1
896,18,1,LL-S,PM,80250,26750,107000,7/2/2024,User1
897,18,1,LL-S,PM,80250,26750,107000,7/2/2024,User1
898,18,1,LL-S,PM,80250,26750,107000,7/2/2024,User1
899,18,1,LL-S,PM,80250,26750,107000,7/2/2024,User1
900,18,1,GP,PR,316500,105500,422000,5/20/2024,User1
901,18,1,GP,PR,316500,105500,422000,5/20/2024,User1
902,18,1,GP,PR,316500,105500,422000,5/20/2024,User1
903,18,1,GP,PR,316500,105500,422000,5/20/2024,User1
904,18,1,GP,PR,316500,105500,422000,5/20/2024,User1
905,18,1,GP,PR,316500,105500,422000,5/20/2024,User1
906,18,1,GP,PR,316500,105500,422000,5/20/2024,User1
907,18,1,GP,PR,316500,105500,422000,5/20/2024,User1
908,18,1,GP,PR,316500,105500,422000,5/20/2024,User1
909,18,1,GP,PR,316500,105500,422000,5/20/2024,User1
910,18,1,GP,PR,316500,105500,422000,5/20/2024,User1
911,18,1,GP,PR,316500,105500,422000,5/20/2024,User1
912,18,1,GP,PR,421500,140500,562000,5/20/2024,User1
913,18,1,GP,PR,421500,140500,562000,5/20/2024,User1
914,18,1,GP,PR,421500,140500,562000,5/20/2024,User1
915,18,1,GP,PR,421500,140500,562000,5/20/2024,User1
916,18,1,GP,PR,421500,140500,562000,5/20/2024,User1
917,18,1,GP,PR,421500,140500,562000,5/20/2024,User1
918,18,1,GP,PR,421500,140500,562000,5/20/2024,User1
919,18,1,GP,PR,421500,140500,562000,5/20/2024,User1
920,18,1,GP,PR,421500,140500,562000,5/20/2024,User1
921,18,1,GP,PR,421500,140500,562000,5/20/2024,User1
922,18,1,GP,PR,421500,140500,562000,5/20/2024,User1
923,18,1,GP,PR,421500,140500,562000,5/20/2024,User1
924,18,1,GP,PR,421500,140500,562000,5/20/2024,User1
925,18,1,GP,PR,421500,140500,562000,5/20/2024,User1
926,18,1,GP,PR,421500,140500,562000,5/20/2024,User1
927,18,1,GP,PR,421500,140500,562000,5/20/2024,User1
928,18,1,LL,PM,80250,26750,107000,5/20/2024,User1
929,18,1,LL,PM,80250,26750,107000,5/20/2024,User1
930,18,1,LL,PM,80250,26750,107000,5/20/2024,User1
931,18,1,LL,PM,80250,26750,107000,5/20/2024,User1
932,18,1,LL,PM,80250,26750,107000,5/20/2024,User1
933,18,1,LL,PM,80250,26750,107000,5/20/2024,User1
934,18,1,LL,PM,80250,26750,107000,5/20/2024,User1
935,18,1,LL,PM,80250,26750,107000,5/20/2024,User1
936,18,1,LL,PM,80250,26750,107000,5/20/2024,User1
937,18,1,LL,PM,80250,26750,107000,5/20/2024,User1
938,18,1,LL,PM,80250,26750,107000,5/20/2024,User1
939,18,1,LL,PM,80250,26750,107000,5/20/2024,User1
940,18,1,LL,PM,80250,26750,107000,5/20/2024,User1
941,18,1,LL,PM,80250,26750,107000,5/20/2024,User1
942,18,1,LL,PM,80250,26750,107000,5/20/2024,User1
943,18,1,LL,PM,80250,26750,107000,5/20/2024,User1
944,18,1,LL,PM,80250,26750,107000,5/20/2024,User1
945,18,1,LL,SP,86250,28750,115000,5/20/2024,User1
946,18,1,LL,SP,86250,28750,115000,5/20/2024,User1
947,18,1,LL,SP,86250,28750,115000,5/20/2024,User1
948,18,1,LL,SP,86250,28750,115000,5/20/2024,User1
949,18,1,LL,SP,86250,28750,115000,5/20/2024,User1
950,18,1,LL,SP,86250,28750,115000,5/20/2024,User1
951,18,1,LL,SP,86250,28750,115000,5/20/2024,User1
952,18,1,LL,SP,86250,28750,115000,5/20/2024,User1
953,18,1,LL,SP,86250,28750,115000,5/20/2024,User1
954,18,1,LL,SP,86250,28750,115000,5/20/2024,User1
955,18,1,LL,SP,86250,28750,115000,5/20/2024,User1
956,18,1,LL,SP,86250,28750,115000,5/20/2024,User1
957,18,1,LL,SP,86250,28750,115000,5/20/2024,User1
958,18,1,LL,SP,86250,28750,115000,5/20/2024,User1
959,18,1,LL,SP,86250,28750,115000,5/20/2024,User1
960,18,1,LL,SP,86250,28750,115000,5/20/2024,User1
961,18,1,LL,SP,86250,28750,115000,5/20/2024,User1
962,18,1,LL,PR,94500,31500,126000,5/20/2024,User1
963,18,1,LL,PR,94500,31500,126000,5/20/2024,User1
964,18,1,LL,PR,94500,31500,126000,5/20/2024,User1
965,18,1,LL,PR,94500,31500,126000,5/20/2024,User1
966,18,1,LL,PR,94500,31500,126000,5/20/2024,User1
967,18,1,LL,PR,94500,31500,126000,5/20/2024,User1
968,18,1,LL,PR,94500,31500,126000,5/20/2024,User1
969,18,1,LL,PR,94500,31500,126000,5/20/2024,User1
970,18,1,LL,PR,94500,31500,126000,5/20/2024,User1
971,18,1,LL,PR,94500,31500,126000,5/20/2024,User1
972,18,1,LL,PR,94500,31500,126000,5/20/2024,User1
973,18,1,LL,PR,94500,31500,126000,5/20/2024,User1
974,18,1,LL,PR,94500,31500,126000,5/20/2024,User1
975,18,1,LL,PR,94500,31500,126000,5/20/2024,User1
976,18,1,LL,PR,94500,31500,126000,5/20/2024,User1
977,18,1,LL,PR,94500,31500,126000,5/20/2024,User1
978,18,1,LL,PR,94500,31500,126000,5/20/2024,User1
979,18,1,LL-S,PM,80250,26750,107000,5/20/2024,User1
980,18,1,LL-S,PM,80250,26750,107000,5/20/2024,User1
981,18,1,LL-S,PM,80250,26750,107000,5/20/2024,User1
982,18,1,LL-S,PM,80250,26750,107000,5/20/2024,User1
983,18,1,LL-S,PM,80250,26750,107000,5/20/2024,User1
984,18,1,LL-S,PM,80250,26750,107000,5/20/2024,User1
985,18,1,LL-S,PM,80250,26750,107000,5/20/2024,User1
986,18,1,LL-S,PM,80250,26750,107000,5/20/2024,User1
987,18,1,LL-S,PM,80250,26750,107000,5/20/2024,User1
988,18,1,LL-S,PM,80250,26750,107000,5/20/2024,User1
989,18,1,LL-S,PM,80250,26750,107000,5/20/2024,User1
990,18,1,LL-S,PM,80250,26750,107000,5/20/2024,User1
991,18,1,LL-S,PM,80250,26750,107000,5/20/2024,User1
992,18,1,LL-S,PM,80250,26750,107000,5/20/2024,User1
993,18,1,LL-S,PM,80250,26750,107000,5/20/2024,User1
994,18,1,LL-S,PM,80250,26750,107000,5/20/2024,User1
995,18,1,LL-S,PM,80250,26750,107000,5/20/2024,User1
996,18,1,LL-S,SP,86250,28750,115000,5/20/2024,User1
997,18,1,LL-S,SP,86250,28750,115000,5/20/2024,User1
998,18,1,LL-S,SP,86250,28750,115000,5/20/2024,User1
999,18,1,LL-S,SP,86250,28750,115000,5/20/2024,User1
1000,18,1,LL-S,SP,86250,28750,115000,5/20/2024,User1
1001,18,1,LL-S,SP,86250,28750,115000,5/20/2024,User1
1002,18,1,LL-S,SP,86250,28750,115000,5/20/2024,User1
1003,18,1,LL-S,SP,86250,28750,115000,5/20/2024,User1
1004,18,1,LL-S,SP,86250,28750,115000,5/20/2024,User1
1005,18,1,LL-S,SP,86250,28750,115000,5/20/2024,User1
1006,18,1,LL-S,SP,86250,28750,115000,5/20/2024,User1
1007,18,1,LL-S,SP,86250,28750,115000,5/20/2024,User1
1008,18,1,LL-S,SP,86250,28750,115000,5/20/2024,User1
1009,18,1,LL-S,SP,86250,28750,115000,5/20/2024,User1
1010,18,1,LL-S,SP,86250,28750,115000,5/20/2024,User1
1011,18,1,LL-S,SP,86250,28750,115000,5/20/2024,User1
1012,18,1,LL-S,SP,86250,28750,115000,5/20/2024,User1
1013,18,1,LL-S,PR,94500,31500,126000,5/20/2024,User1
1014,18,1,LL-S,PR,94500,31500,126000,5/20/2024,User1
1015,18,1,LL-S,PR,94500,31500,126000,5/20/2024,User1
1016,18,1,LL-S,PR,94500,31500,126000,5/20/2024,User1
1017,18,1,LL-S,PR,94500,31500,126000,5/20/2024,User1
1018,18,1,LL-S,PR,94500,31500,126000,5/20/2024,User1
1019,18,1,LL-S,PR,94500,31500,126000,5/20/2024,User1
1020,18,1,LL-S,PR,94500,31500,126000,5/20/2024,User1
1021,18,1,LL-S,PR,94500,31500,126000,5/20/2024,User1
1022,18,1,LL-S,PR,94500,31500,126000,5/20/2024,User1
1023,18,1,LL-S,PR,94500,31500,126000,5/20/2024,User1
1024,18,1,LL-S,PR,94500,31500,126000,5/20/2024,User1
1025,18,1,LL-S,PR,94500,31500,126000,5/20/2024,User1
1026,18,1,LL-S,PR,94500,31500,126000,5/20/2024,User1
1027,18,1,LL-S,PR,94500,31500,126000,5/20/2024,User1
1028,18,1,LL-S,PR,94500,31500,126000,5/20/2024,User1
1029,18,1,LL-S,PR,94500,31500,126000,5/20/2024,User1
1030,18,1,FE,FE12-PM,1237500,412500,1650000,5/20/2024,User1
1031,18,1,FE,FE12-PM,1237500,412500,1650000,5/20/2024,User1
1032,18,1,FE,FE12-PM,1237500,412500,1650000,5/20/2024,User1
1033,18,1,FE,FE12-PM,1237500,412500,1650000,5/20/2024,User1
1034,18,1,FE,FE12-PM,1237500,412500,1650000,5/20/2024,User1
1035,18,1,FE,FE12-PM,1237500,412500,1650000,5/20/2024,User1
1036,18,1,FE,FE12-PM,1237500,412500,1650000,5/20/2024,User1
1037,18,1,FE,FE12-PM,1237500,412500,1650000,5/20/2024,User1
1038,18,1,FE,FE12-PM,1237500,412500,1650000,5/20/2024,User1
1039,18,1,FE,FE12-PM,1237500,412500,1650000,5/20/2024,User1
1040,18,1,FE,FE12-PM,1237500,412500,1650000,5/20/2024,User1
1041,18,1,FE,FE12-PM,1237500,412500,1650000,5/20/2024,User1
1042,18,1,FE,FE12-PM,1237500,412500,1650000,5/20/2024,User1
1043,18,1,FE,FE12-PM,1237500,412500,1650000,5/20/2024,User1
1044,18,1,FE,FE12-PM,1237500,412500,1650000,5/20/2024,User1
1045,18,1,FE,FE12-PM,1237500,412500,1650000,5/20/2024,User1
1046,18,1,FE,FE12-PM,1237500,412500,1650000,5/20/2024,User1
1047,18,1,LLO,PR,45750,15250,61000,5/20/2024,User1
1048,18,1,LLO,PR,45750,15250,61000,5/20/2024,User1
1049,18,1,LLO,PR,45750,15250,61000,5/20/2024,User1
1050,18,1,LLO,PR,45750,15250,61000,5/20/2024,User1
1051,18,1,LLO,PR,45750,15250,61000,5/20/2024,User1
1052,18,1,LLO,PR,45750,15250,61000,5/20/2024,User1
1053,18,1,LLO,PR,45750,15250,61000,5/20/2024,User1
1054,18,1,GP,PM,270000,90000,360000,5/20/2024,User1
1055,18,1,GP,PM,270000,90000,360000,5/20/2024,User1
1056,18,1,GP,PM,270000,90000,360000,5/20/2024,User1
1057,18,1,GP,PM,270000,90000,360000,5/20/2024,User1
1058,18,1,GP,PM,270000,90000,360000,5/20/2024,User1
1059,18,1,GP,PM,270000,90000,360000,5/20/2024,User1
1060,18,1,GP,PM,270000,90000,360000,5/20/2024,User1
1061,18,1,GP,PM,270000,90000,360000,5/20/2024,User1
1062,18,1,GP,PM,270000,90000,360000,5/20/2024,User1
1063,18,1,GP,PM,270000,90000,360000,5/20/2024,User1
1064,18,1,GP,PM,270000,90000,360000,5/20/2024,User1
1065,18,1,GP,PM,270000,90000,360000,5/20/2024,User1
1066,18,1,GP,PM,270000,90000,360000,5/20/2024,User1
1067,18,1,GP,PM,270000,90000,360000,5/20/2024,User1
1068,18,1,GP,PM,270000,90000,360000,5/20/2024,User1
1069,18,1,GP,PM,270000,90000,360000,5/20/2024,User1
1070,18,1,GP,PM,270000,90000,360000,5/20/2024,User1
1071,18,1,GP,SP,289500,96500,386000,5/20/2024,User1
1072,18,1,GP,SP,289500,96500,386000,5/20/2024,User1
1073,18,1,GP,SP,289500,96500,386000,5/20/2024,User1
1074,18,1,GP,SP,289500,96500,386000,5/20/2024,User1
1075,18,1,GP,SP,289500,96500,386000,5/20/2024,User1
1076,18,1,GP,SP,289500,96500,386000,5/20/2024,User1
1077,18,1,GP,SP,289500,96500,386000,5/20/2024,User1
1078,18,1,GP,SP,289500,96500,386000,5/20/2024,User1
1079,18,1,GP,SP,289500,96500,386000,5/20/2024,User1
1080,18,1,GP,SP,289500,96500,386000,5/20/2024,User1
1081,18,1,GP,SP,289500,96500,386000,5/20/2024,User1
1082,18,1,GP,SP,289500,96500,386000,5/20/2024,User1
1083,18,1,GP,SP,289500,96500,386000,5/20/2024,User1
1084,18,1,GP,SP,289500,96500,386000,5/20/2024,User1
1085,18,1,GP,SP,289500,96500,386000,5/20/2024,User1
1086,18,1,GP,SP,289500,96500,386000,5/20/2024,User1
1087,18,1,GP,SP,289500,96500,386000,5/20/2024,User1
1088,18,1,GP,PR,316500,105500,422000,5/20/2024,User1
1089,18,1,GP,PR,316500,105500,422000,5/20/2024,User1
1090,18,1,GP,PR,316500,105500,422000,5/20/2024,User1
1091,18,1,GP,PR,421500,140500,562000,5/20/2024,User1
1092,18,1,GP,PR,316500,105500,422000,5/20/2024,User1
1093,18,1,GP,PR,316500,105500,422000,5/20/2024,User1
1094,18,1,LL-S,PM,80250,26750,107000,7/2/2024,User1
1095,18,1,LL-S,PM,80250,26750,107000,7/2/2024,User1
1096,18,1,LL-S,PM,80250,26750,107000,7/2/2024,User1
1097,18,1,LL-S,PM,80250,26750,107000,7/2/2024,User1
1098,18,1,LL-S,PM,80250,26750,107000,7/2/2024,User1
1099,18,1,LL-S,PM,80250,26750,107000,7/2/2024,User1
1100,18,1,LL-S,PM,80250,26750,107000,7/2/2024,User1
1101,18,1,LL-S,PM,80250,26750,107000,7/2/2024,User1
1102,18,1,LL-S,PM,80250,26750,107000,7/2/2024,User1
1103,18,1,LL-S,PM,80250,26750,107000,7/2/2024,User1
1104,18,1,LL-S,PM,80250,26750,107000,7/2/2024,User1
1105,18,1,LL-S,PM,80250,26750,107000,7/2/2024,User1
1106,18,1,LL-S,PM,80250,26750,107000,7/2/2024,User1
1107,18,1,LL-S,SP,86250,28750,115000,7/2/2024,User1
1108,18,1,LL-S,SP,86250,28750,115000,7/2/2024,User1
1109,18,1,LL-S,SP,86250,28750,115000,7/2/2024,User1
1110,18,1,LL-S,SP,86250,28750,115000,7/2/2024,User1
1111,18,1,LL-S,SP,86250,28750,115000,7/2/2024,User1
1112,18,1,LL-S,SP,86250,28750,115000,7/2/2024,User1
1113,18,1,LL-S,SP,86250,28750,115000,7/2/2024,User1
1114,18,1,LL-S,SP,86250,28750,115000,7/2/2024,User1
1115,18,1,LL-S,SP,86250,28750,115000,7/2/2024,User1
1116,18,1,LL-S,SP,86250,28750,115000,7/2/2024,User1
1117,18,1,LL-S,SP,86250,28750,115000,7/2/2024,User1
1118,18,1,LL-S,SP,86250,28750,115000,7/2/2024,User1
1119,18,1,LL-S,SP,86250,28750,115000,7/2/2024,User1
1120,18,1,LL-S,SP,86250,28750,115000,7/2/2024,User1
1121,18,1,LL-S,SP,86250,28750,115000,7/2/2024,User1
1122,18,1,LL-S,SP,86250,28750,115000,7/2/2024,User1
1123,18,1,LL-S,SP,86250,28750,115000,7/2/2024,User1
1124,18,1,LL-S,PR,94500,31500,126000,7/2/2024,User1
1125,18,1,LL-S,PR,94500,31500,126000,7/2/2024,User1
1126,18,1,LL-S,PR,94500,31500,126000,7/2/2024,User1
1127,18,1,LL-S,PR,94500,31500,126000,7/2/2024,User1
1128,18,1,LL-S,PR,94500,31500,126000,7/2/2024,User1
1129,18,1,LL-S,PR,94500,31500,126000,7/2/2024,User1
1130,18,1,LL-S,PR,94500,31500,126000,7/2/2024,User1
1131,18,1,LL-S,PR,94500,31500,126000,7/2/2024,User1
1132,18,1,LL-S,PR,94500,31500,126000,7/2/2024,User1
1133,18,1,LL-S,PR,94500,31500,126000,7/2/2024,User1
1134,18,1,LL-S,PR,94500,31500,126000,7/2/2024,User1
1135,18,1,LL-S,PR,94500,31500,126000,7/2/2024,User1
1136,18,1,LL-S,PR,94500,31500,126000,7/2/2024,User1
1137,18,1,LL-S,PR,94500,31500,126000,7/2/2024,User1
1138,18,1,LL-S,PR,94500,31500,126000,7/2/2024,User1
1139,18,1,LL-S,PR,94500,31500,126000,7/2/2024,User1
1140,18,1,LL-S,PR,94500,31500,126000,7/2/2024,User1
1141,18,1,LL,SP,86250,28750,115000,5/21/2024,User1
1142,18,1,LL,SP,86250,28750,115000,5/21/2024,User1
1143,18,1,LL,PR,94500,31500,126000,5/21/2024,User1
1144,18,1,LL,PR,94500,31500,126000,5/21/2024,User1
1145,18,1,LL,PR,94500,31500,126000,5/21/2024,User1
1146,18,1,LL,PR,94500,31500,126000,5/21/2024,User1
1147,18,1,LL,PR,94500,31500,126000,5/21/2024,User1
1148,18,1,LL,PR,94500,31500,126000,5/21/2024,User1
1149,18,1,LL,PR,94500,31500,126000,5/21/2024,User1
1150,18,1,LL,PR,94500,31500,126000,5/21/2024,User1
1151,18,1,LL,PR,94500,31500,126000,5/21/2024,User1
1152,18,1,LL,PR,94500,31500,126000,5/21/2024,User1
1153,18,1,LL,PR,94500,31500,126000,5/21/2024,User1
1154,18,1,LL,PR,94500,31500,126000,5/21/2024,User1
1155,18,1,LL,PR,94500,31500,126000,5/21/2024,User1
1156,18,1,LL,PR,94500,31500,126000,5/21/2024,User1
1157,18,1,LL,PR,94500,31500,126000,5/21/2024,User1
1158,18,1,LL,PR,94500,31500,126000,5/21/2024,User1
1159,18,1,LL,PR,94500,31500,126000,5/21/2024,User1
1160,18,1,LL-S,PM,80250,26750,107000,5/21/2024,User1
1161,18,1,LL-S,PM,80250,26750,107000,5/21/2024,User1
1162,18,1,LL-S,PM,80250,26750,107000,5/21/2024,User1
1163,18,1,LL-S,PM,80250,26750,107000,5/21/2024,User1
1164,18,1,LL-S,PM,80250,26750,107000,5/21/2024,User1
1165,18,1,LL-S,PM,80250,26750,107000,5/21/2024,User1
1166,18,1,LL-S,PM,80250,26750,107000,5/21/2024,User1
1167,18,1,LL-S,PM,80250,26750,107000,5/21/2024,User1
1168,18,1,LL-S,PM,80250,26750,107000,5/21/2024,User1
1169,18,1,LL-S,PM,80250,26750,107000,5/21/2024,User1
1170,18,1,LL-S,PM,80250,26750,107000,5/21/2024,User1
1171,18,1,LL-S,PM,80250,26750,107000,5/21/2024,User1
1172,18,1,LL-S,PM,80250,26750,107000,5/21/2024,User1
1173,18,1,LL-S,PM,80250,26750,107000,5/21/2024,User1
1174,18,1,LL-S,PM,80250,26750,107000,5/21/2024,User1
1175,18,1,LL-S,PM,80250,26750,107000,5/21/2024,User1
1176,18,1,LL-S,PM,80250,26750,107000,5/21/2024,User1
1177,18,1,LL-S,SP,86250,28750,115000,5/21/2024,User1
1178,18,1,LL-S,SP,86250,28750,115000,5/21/2024,User1
1179,18,1,LL-S,SP,86250,28750,115000,5/21/2024,User1
1180,18,1,LL-S,SP,86250,28750,115000,5/21/2024,User1
1181,18,1,LL-S,SP,86250,28750,115000,5/21/2024,User1
1182,18,1,LL-S,SP,86250,28750,115000,5/21/2024,User1
1183,18,1,LL-S,SP,86250,28750,115000,5/21/2024,User1
1184,18,1,LL-S,SP,86250,28750,115000,5/21/2024,User1
1185,18,1,LL-S,SP,86250,28750,115000,5/21/2024,User1
1186,18,1,LL-S,SP,86250,28750,115000,5/21/2024,User1
1187,18,1,LL-S,SP,86250,28750,115000,5/21/2024,User1
1188,18,1,LL-S,SP,86250,28750,115000,5/21/2024,User1
1189,18,1,LL-S,SP,86250,28750,115000,5/21/2024,User1
1190,18,1,LL-S,SP,86250,28750,115000,5/21/2024,User1
1191,18,1,LL-S,SP,86250,28750,115000,5/21/2024,User1
1192,18,1,LL-S,SP,86250,28750,115000,5/21/2024,User1
1193,18,1,LL-S,SP,86250,28750,115000,5/21/2024,User1
1194,18,1,LL-S,PR,94500,31500,126000,5/21/2024,User1
1195,18,1,LL-S,PR,94500,31500,126000,5/21/2024,User1
1196,18,1,LL-S,PR,94500,31500,126000,5/21/2024,User1
1197,18,1,LL-S,PR,94500,31500,126000,5/21/2024,User1
1198,18,1,LL-S,PR,94500,31500,126000,5/21/2024,User1
1199,18,1,LL-S,PR,94500,31500,126000,5/21/2024,User1
1200,18,1,LL-S,PR,94500,31500,126000,5/21/2024,User1
1201,18,1,LL-S,PR,94500,31500,126000,5/21/2024,User1
1202,18,1,LL-S,PR,94500,31500,126000,5/21/2024,User1
1203,18,1,LL-S,PR,94500,31500,126000,5/21/2024,User1
1204,18,1,LL-S,PR,94500,31500,126000,5/21/2024,User1
1205,18,1,LL-S,PR,94500,31500,126000,5/21/2024,User1
1206,18,1,LL-S,PR,94500,31500,126000,5/21/2024,User1
1207,18,1,LL-S,PR,94500,31500,126000,5/21/2024,User1
1208,18,1,LL-S,PR,94500,31500,126000,5/21/2024,User1
1209,18,1,LL-S,PR,94500,31500,126000,5/21/2024,User1
1210,18,1,LL-S,PR,94500,31500,126000,5/21/2024,User1
1211,18,1,FE,FE12-PM,1237500,412500,1650000,5/21/2024,User1
1212,18,1,FE,FE12-PM,1237500,412500,1650000,5/21/2024,User1
1213,18,1,FE,FE12-PM,1237500,412500,1650000,5/21/2024,User1
1214,18,1,FE,FE12-PM,1237500,412500,1650000,5/21/2024,User1
1215,18,1,FE,FE12-PM,1237500,412500,1650000,5/21/2024,User1
1216,18,1,FE,FE12-PM,1237500,412500,1650000,5/21/2024,User1
1217,18,1,FE,FE12-PM,1237500,412500,1650000,5/21/2024,User1
1218,18,1,FE,FE12-PM,1237500,412500,1650000,5/21/2024,User1
1219,18,1,FE,FE12-PM,1237500,412500,1650000,5/21/2024,User1
1220,18,1,FE,FE12-PM,1237500,412500,1650000,5/21/2024,User1
1221,18,1,FE,FE12-PM,1237500,412500,1650000,5/21/2024,User1
1222,18,1,FE,FE12-PM,1237500,412500,1650000,5/21/2024,User1
1223,18,1,FE,FE12-PM,1237500,412500,1650000,5/21/2024,User1
1224,18,1,FE,FE12-PM,1237500,412500,1650000,5/21/2024,User1
1225,18,1,FE,FE12-PM,1237500,412500,1650000,5/21/2024,User1
1226,18,1,FE,FE12-PM,1237500,412500,1650000,5/21/2024,User1
1227,18,1,FE,FE12-PM,1237500,412500,1650000,5/21/2024,User1
1228,18,1,LLO,PR,45750,15250,61000,5/21/2024,User1
1229,18,1,LLO,PR,45750,15250,61000,5/21/2024,User1
1230,18,1,LLO,PR,45750,15250,61000,5/21/2024,User1
1231,18,1,LLO,PR,45750,15250,61000,5/21/2024,User1
1232,18,1,LLO,PR,45750,15250,61000,5/21/2024,User1
1233,18,1,LLO,PR,45750,15250,61000,5/21/2024,User1
1234,18,1,LLO,PR,45750,15250,61000,5/21/2024,User1
1235,18,1,GP,PM,270000,90000,360000,5/21/2024,User1
1236,18,1,GP,PM,270000,90000,360000,5/21/2024,User1
1237,18,1,GP,PM,270000,90000,360000,5/21/2024,User1
1238,18,1,GP,PM,270000,90000,360000,5/21/2024,User1
1239,18,1,GP,PM,270000,90000,360000,5/21/2024,User1
1240,18,1,GP,PM,270000,90000,360000,5/21/2024,User1
1241,18,1,GP,PM,270000,90000,360000,5/21/2024,User1
1242,18,1,GP,PM,270000,90000,360000,5/21/2024,User1
1243,18,1,GP,PM,270000,90000,360000,5/21/2024,User1
1244,18,1,GP,PM,270000,90000,360000,5/21/2024,User1
1245,18,1,GP,PM,270000,90000,360000,5/21/2024,User1
1246,18,1,GP,PM,270000,90000,360000,5/21/2024,User1
1247,18,1,GP,PM,270000,90000,360000,5/21/2024,User1
1248,18,1,GP,PM,270000,90000,360000,5/21/2024,User1
1249,18,1,GP,PM,270000,90000,360000,5/21/2024,User1
1250,18,1,GP,PM,270000,90000,360000,5/21/2024,User1
1251,18,1,GP,PM,270000,90000,360000,5/21/2024,User1
1252,18,1,GP,SP,289500,96500,386000,5/21/2024,User1
1253,18,1,GP,SP,289500,96500,386000,5/21/2024,User1
1254,18,1,GP,SP,289500,96500,386000,5/21/2024,User1
1255,18,1,GP,SP,289500,96500,386000,5/21/2024,User1
1256,18,1,GP,SP,289500,96500,386000,5/21/2024,User1
1257,18,1,GP,SP,289500,96500,386000,5/21/2024,User1
1258,18,1,GP,SP,289500,96500,386000,5/21/2024,User1
1259,18,1,GP,SP,289500,96500,386000,5/21/2024,User1
1260,18,1,GP,SP,289500,96500,386000,5/21/2024,User1
1261,18,1,GP,SP,289500,96500,386000,5/21/2024,User1
1262,18,1,GP,SP,289500,96500,386000,5/21/2024,User1
1263,18,1,GP,SP,289500,96500,386000,5/21/2024,User1
1264,18,1,GP,SP,289500,96500,386000,5/21/2024,User1
1265,18,1,GP,SP,289500,96500,386000,5/21/2024,User1
1266,18,1,GP,SP,289500,96500,386000,5/21/2024,User1
1267,18,1,GP,SP,289500,96500,386000,5/21/2024,User1
1268,18,1,GP,SP,289500,96500,386000,5/21/2024,User1
1269,18,1,GP,PR,316500,105500,422000,5/21/2024,User1
1270,18,1,GP,PR,316500,105500,422000,5/21/2024,User1
1271,18,1,GP,PR,316500,105500,422000,5/21/2024,User1
1272,18,1,GP,PR,316500,105500,422000,5/21/2024,User1
1273,18,1,GP,PR,316500,105500,422000,5/21/2024,User1
1274,18,1,GP,PR,316500,105500,422000,5/21/2024,User1
1275,18,1,GP,PR,316500,105500,422000,5/21/2024,User1
1276,18,1,GP,PR,316500,105500,422000,5/21/2024,User1
1277,18,1,GP,PR,316500,105500,422000,5/21/2024,User1
1278,18,1,GP,PR,316500,105500,422000,5/21/2024,User1
1279,18,1,GP,PR,316500,105500,422000,5/21/2024,User1
1280,18,1,GP,PR,316500,105500,422000,5/21/2024,User1
1281,18,1,GP,PR,316500,105500,422000,5/21/2024,User1
1282,18,1,GP,PR,316500,105500,422000,5/21/2024,User1
1283,18,1,GP,PR,316500,105500,422000,5/21/2024,User1
1284,18,1,GP,PR,316500,105500,422000,5/21/2024,User1
1285,18,1,GP,PR,316500,105500,422000,5/21/2024,User1
1286,18,1,GP,PR,421500,140500,562000,5/21/2024,User1
1287,18,1,GP,PR,421500,140500,562000,5/21/2024,User1
1288,18,1,GP,PR,421500,140500,562000,5/21/2024,User1
1289,18,1,GP,PR,421500,140500,562000,5/21/2024,User1
1290,18,1,GP,PR,421500,140500,562000,5/21/2024,User1
1291,18,1,GP,PR,421500,140500,562000,5/21/2024,User1
1292,18,1,GP,PR,421500,140500,562000,5/21/2024,User1
1293,18,1,GP,PR,421500,140500,562000,5/21/2024,User1
1294,18,1,GP,PR,421500,140500,562000,5/21/2024,User1
1295,18,1,GP,PR,421500,140500,562000,5/21/2024,User1
1296,18,1,GP,PR,421500,140500,562000,5/21/2024,User1
1297,18,1,GP,PR,421500,140500,562000,5/21/2024,User1
1298,18,1,GP,PR,421500,140500,562000,5/21/2024,User1
1299,18,1,GP,PR,421500,140500,562000,5/21/2024,User1
1300,18,1,GP,PR,421500,140500,562000,5/21/2024,User1
1301,18,1,GP,PR,421500,140500,562000,5/21/2024,User1
1302,18,1,GP,PR,421500,140500,562000,5/21/2024,User1
1303,18,1,LL,PM,80250,26750,107000,5/21/2024,User1
1304,18,1,LL,PM,80250,26750,107000,5/21/2024,User1
1305,18,1,LL,PM,80250,26750,107000,5/21/2024,User1
1306,18,1,LL,SP,86250,28750,115000,5/21/2024,User1
1307,18,1,LL,SP,86250,28750,115000,5/21/2024,User1
1308,18,1,LL,SP,86250,28750,115000,5/21/2024,User1
1309,18,1,LL,PR,94500,31500,126000,5/21/2024,User1
1310,18,1,LL,PR,94500,31500,126000,5/21/2024,User1
1311,18,1,LL,PR,94500,31500,126000,5/21/2024,User1
1312,18,1,LL-S,PM,80250,26750,107000,5/21/2024,User1
1313,18,1,LL-S,PM,80250,26750,107000,5/21/2024,User1
1314,18,1,LL-S,PM,80250,26750,107000,5/21/2024,User1
1315,18,1,LL-S,SP,86250,28750,115000,5/21/2024,User1
1316,18,1,LL-S,SP,86250,28750,115000,5/21/2024,User1
1317,18,1,LL-S,SP,86250,28750,115000,5/21/2024,User1
1318,18,1,LL-S,PR,94500,31500,126000,5/21/2024,User1
1319,18,1,LL-S,PR,94500,31500,126000,5/21/2024,User1
1320,18,1,LL-S,PR,94500,31500,126000,5/21/2024,User1
1321,18,1,LL,PM,80250,26750,107000,5/21/2024,User1
1322,18,1,LL,PM,80250,26750,107000,5/21/2024,User1
1323,18,1,LL,PM,80250,26750,107000,5/21/2024,User1
1324,18,1,LL,PM,80250,26750,107000,5/21/2024,User1
1325,18,1,LL,PM,80250,26750,107000,5/21/2024,User1
1326,18,1,LL,PM,80250,26750,107000,5/21/2024,User1
1327,18,1,LL,PM,80250,26750,107000,5/21/2024,User1
1328,18,1,LL,PM,80250,26750,107000,5/21/2024,User1
1329,18,1,LL,PM,80250,26750,107000,5/21/2024,User1
1330,18,1,LL,PM,80250,26750,107000,5/21/2024,User1
1331,18,1,LL,PM,80250,26750,107000,5/21/2024,User1
1332,18,1,LL,PM,80250,26750,107000,5/21/2024,User1
1333,18,1,LL,PM,80250,26750,107000,5/21/2024,User1
1334,18,1,LL,PM,80250,26750,107000,5/21/2024,User1
1335,18,1,LL,PM,80250,26750,107000,5/21/2024,User1
1336,18,1,LL,PM,80250,26750,107000,5/21/2024,User1
1337,18,1,LL,PM,80250,26750,107000,5/21/2024,User1
1338,18,1,LL,SP,86250,28750,115000,5/21/2024,User1
1339,18,1,LL,SP,86250,28750,115000,5/21/2024,User1
1340,18,1,LL,SP,86250,28750,115000,5/21/2024,User1
1341,18,1,LL,SP,86250,28750,115000,5/21/2024,User1
1342,18,1,LL,SP,86250,28750,115000,5/21/2024,User1
1343,18,1,LL,SP,86250,28750,115000,5/21/2024,User1
1344,18,1,LL,SP,86250,28750,115000,5/21/2024,User1
1345,18,1,LL,SP,86250,28750,115000,5/21/2024,User1
1346,18,1,LL,SP,86250,28750,115000,5/21/2024,User1
1347,18,1,LL,SP,86250,28750,115000,5/21/2024,User1
1348,18,1,LL,SP,86250,28750,115000,5/21/2024,User1
1349,18,1,LL,SP,86250,28750,115000,5/21/2024,User1
1350,18,1,LL,SP,86250,28750,115000,5/21/2024,User1
1351,18,1,LL,SP,86250,28750,115000,5/21/2024,User1
1352,18,1,LL,SP,86250,28750,115000,5/21/2024,User1
1353,18,1,FE,FE12-PM,1237500,412500,1650000,7/2/2024,User1
1354,18,1,FE,FE12-PM,1237500,412500,1650000,7/2/2024,User1
1355,18,1,FE,FE12-PM,1237500,412500,1650000,7/2/2024,User1
1356,18,1,FE,FE12-PM,1237500,412500,1650000,7/2/2024,User1
1357,18,1,FE,FE12-PM,1237500,412500,1650000,7/2/2024,User1
1358,18,1,FE,FE12-PM,1237500,412500,1650000,7/2/2024,User1
1359,18,1,FE,FE12-PM,1237500,412500,1650000,7/2/2024,User1
1360,18,1,FE,FE12-PM,1237500,412500,1650000,7/2/2024,User1
1361,18,1,FE,FE12-PM,1237500,412500,1650000,7/2/2024,User1
1362,18,1,FE,FE12-PM,1237500,412500,1650000,7/2/2024,User1
1363,18,1,FE,FE12-PM,1237500,412500,1650000,7/2/2024,User1
1364,18,1,FE,FE12-PM,1237500,412500,1650000,7/2/2024,User1
1365,18,1,FE,FE12-PM,1237500,412500,1650000,7/2/2024,User1
1366,18,1,FE,FE12-PM,1237500,412500,1650000,7/2/2024,User1
1367,18,1,FE,FE12-PM,1237500,412500,1650000,7/2/2024,User1
1368,18,1,FE,FE12-PM,1237500,412500,1650000,7/2/2024,User1
1369,18,1,FE,FE12-PM,1237500,412500,1650000,7/2/2024,User1
1370,18,1,FE,FE12-SP,1282500,427500,1710000,7/2/2024,User1
1371,18,1,FE,FE12-SP,1282500,427500,1710000,7/2/2024,User1
1372,18,1,FE,FE12-SP,1282500,427500,1710000,7/2/2024,User1
1373,18,1,FE,FE12-SP,1282500,427500,1710000,7/2/2024,User1
1374,18,1,FE,FE12-SP,1282500,427500,1710000,7/2/2024,User1
1375,18,1,FE,FE12-SP,1282500,427500,1710000,7/2/2024,User1
1376,18,1,FE,FE12-SP,1282500,427500,1710000,7/2/2024,User1
1377,18,1,FE,FE12-SP,1282500,427500,1710000,7/2/2024,User1
1378,18,1,FE,FE12-SP,1282500,427500,1710000,7/2/2024,User1
1379,18,1,FE,FE12-SP,1282500,427500,1710000,7/2/2024,User1
1380,18,1,FE,FE12-SP,1282500,427500,1710000,7/2/2024,User1
1381,18,1,FE,FE12-SP,1282500,427500,1710000,7/2/2024,User1
1382,18,1,FE,FE12-SP,1282500,427500,1710000,7/2/2024,User1
1383,18,1,FE,FE12-SP,1282500,427500,1710000,7/2/2024,User1
1384,18,1,FE,FE12-SP,1282500,427500,1710000,7/2/2024,User1
1385,18,1,FE,FE12-SP,1282500,427500,1710000,7/2/2024,User1
1386,18,1,FE,FE12-SP,1282500,427500,1710000,7/2/2024,User1
1387,18,1,FE,FE12-PR,1372500,457500,1830000,7/2/2024,User1
1388,18,1,FE,FE12-PR,1372500,457500,1830000,7/2/2024,User1
1389,18,1,FE,FE12-PR,1372500,457500,1830000,7/2/2024,User1
1390,18,1,FE,FE12-PR,1372500,457500,1830000,7/2/2024,User1
1391,18,1,FE,FE12-PR,1372500,457500,1830000,7/2/2024,User1
1392,18,1,FE,FE12-PR,1372500,457500,1830000,7/2/2024,User1
1393,18,1,FE,FE12-PR,1372500,457500,1830000,7/2/2024,User1
1394,18,1,FE,FE12-PR,1372500,457500,1830000,7/2/2024,User1
1395,18,1,FE,FE12-PR,1372500,457500,1830000,7/2/2024,User1
1396,18,1,FE,FE12-PR,1372500,457500,1830000,7/2/2024,User1
1397,18,1,FE,FE12-PR,1372500,457500,1830000,7/2/2024,User1
1398,18,1,FE,FE12-PR,1372500,457500,1830000,7/2/2024,User1
1399,18,1,FE,FE12-PR,1372500,457500,1830000,7/2/2024,User1
1400,18,1,FE,FE12-PR,1372500,457500,1830000,7/2/2024,User1
1401,18,1,FE,FE12-PR,1372500,457500,1830000,7/2/2024,User1
1402,18,1,FE,FE12-PR,1372500,457500,1830000,7/2/2024,User1
1403,18,1,FE,FE12-PR,1372500,457500,1830000,7/2/2024,User1
1404,18,1,LLO,PR,45750,15250,61000,7/2/2024,User1
1405,18,1,LLO,PR,45750,15250,61000,7/2/2024,User1
1406,18,1,LLO,PR,45750,15250,61000,7/2/2024,User1
1407,18,1,LLO,PR,45750,15250,61000,7/2/2024,User1
1408,18,1,LLO,PR,45750,15250,61000,7/2/2024,User1
1409,18,1,LLO,PR,45750,15250,61000,7/2/2024,User1
1410,18,1,GP,PM,270000,90000,360000,7/2/2024,User1
1411,18,1,GP,PM,270000,90000,360000,7/2/2024,User1
1412,18,1,GP,PM,270000,90000,360000,7/2/2024,User1
1413,18,1,GP,PM,270000,90000,360000,7/2/2024,User1
1414,18,1,GP,PM,270000,90000,360000,7/2/2024,User1
1415,18,1,GP,PM,270000,90000,360000,7/2/2024,User1
1416,18,1,GP,PM,270000,90000,360000,7/2/2024,User1
1417,18,1,GP,PM,270000,90000,360000,7/2/2024,User1
1418,18,1,GP,PM,270000,90000,360000,7/2/2024,User1
1419,18,1,GP,PM,270000,90000,360000,7/2/2024,User1
1420,18,1,GP,PM,270000,90000,360000,7/2/2024,User1
1421,18,1,GP,PM,270000,90000,360000,7/2/2024,User1
1422,18,1,GP,PM,270000,90000,360000,7/2/2024,User1
1423,18,1,GP,PM,270000,90000,360000,7/2/2024,User1
1424,18,1,GP,PM,270000,90000,360000,7/2/2024,User1
1425,18,1,GP,PM,270000,90000,360000,7/2/2024,User1
1426,18,1,GP,PM,270000,90000,360000,7/2/2024,User1
1427,18,1,GP,SP,289500,96500,386000,7/2/2024,User1
1428,18,1,GP,SP,289500,96500,386000,7/2/2024,User1
1429,18,1,GP,SP,289500,96500,386000,7/2/2024,User1
1430,18,1,GP,SP,289500,96500,386000,7/2/2024,User1
1431,18,1,GP,SP,289500,96500,386000,7/2/2024,User1
1432,18,1,GP,SP,289500,96500,386000,7/2/2024,User1
1433,18,1,GP,SP,289500,96500,386000,7/2/2024,User1
1434,18,1,GP,SP,289500,96500,386000,7/2/2024,User1
1435,18,1,GP,SP,289500,96500,386000,7/2/2024,User1
1436,18,1,GP,SP,289500,96500,386000,7/2/2024,User1
1437,18,1,GP,SP,289500,96500,386000,7/2/2024,User1
1438,18,1,GP,SP,289500,96500,386000,7/2/2024,User1
1439,18,1,GP,SP,289500,96500,386000,7/2/2024,User1
1440,18,1,GP,SP,289500,96500,386000,7/2/2024,User1
1441,18,1,GP,SP,289500,96500,386000,7/2/2024,User1
1442,18,1,GP,SP,289500,96500,386000,7/2/2024,User1
1443,18,1,GP,SP,289500,96500,386000,7/2/2024,User1
1444,18,1,GP,PR,316500,105500,422000,7/2/2024,User1
1445,18,1,GP,PR,316500,105500,422000,7/2/2024,User1
1446,18,1,GP,PR,316500,105500,422000,7/2/2024,User1
1447,18,1,GP,PR,316500,105500,422000,7/2/2024,User1
1448,18,1,GP,PR,316500,105500,422000,7/2/2024,User1
1449,18,1,GP,PR,316500,105500,422000,7/2/2024,User1
1450,18,1,GP,PR,316500,105500,422000,7/2/2024,User1
1451,18,1,GP,PR,316500,105500,422000,7/2/2024,User1
1452,18,1,GP,PR,316500,105500,422000,7/2/2024,User1
1453,18,1,GP,PR,316500,105500,422000,7/2/2024,User1
1454,18,1,GP,PR,316500,105500,422000,7/2/2024,User1
1455,18,1,GP,PR,316500,105500,422000,7/2/2024,User1
1456,18,1,GP,PR,316500,105500,422000,7/2/2024,User1
1457,18,1,GP,PR,316500,105500,422000,7/2/2024,User1
1458,18,1,GP,PR,316500,105500,422000,7/2/2024,User1
1459,18,1,GP,PR,316500,105500,422000,7/2/2024,User1
1460,18,1,GP,PR,316500,105500,422000,7/2/2024,User1
1461,18,1,GP,PR,421500,140500,562000,7/2/2024,User1
1462,18,1,GP,PR,421500,140500,562000,7/2/2024,User1
1463,18,1,GP,PR,421500,140500,562000,7/2/2024,User1
1464,18,1,GP,PR,421500,140500,562000,7/2/2024,User1
1465,18,1,GP,PR,421500,140500,562000,7/2/2024,User1
1466,18,1,GP,PR,421500,140500,562000,7/2/2024,User1
1467,18,1,GP,PR,421500,140500,562000,7/2/2024,User1
1468,18,1,GP,PR,421500,140500,562000,7/2/2024,User1
1469,18,1,GP,PR,421500,140500,562000,7/2/2024,User1
1470,18,1,GP,PR,421500,140500,562000,7/2/2024,User1
1471,18,1,GP,PR,421500,140500,562000,7/2/2024,User1
1472,18,1,GP,PR,421500,140500,562000,7/2/2024,User1
1473,18,1,GP,PR,421500,140500,562000,7/2/2024,User1
1474,18,1,GP,PR,421500,140500,562000,7/2/2024,User1
1475,18,1,GP,PR,421500,140500,562000,7/2/2024,User1
1476,18,1,GP,PR,421500,140500,562000,7/2/2024,User1
1477,18,1,GP,PR,421500,140500,562000,7/2/2024,User1
1478,18,1,LL,PM,80250,26750,107000,7/2/2024,User1
1479,18,1,LL,PM,80250,26750,107000,7/2/2024,User1
1480,18,1,LL,PM,80250,26750,107000,7/2/2024,User1
1481,18,1,LL,PM,80250,26750,107000,7/2/2024,User1
1482,18,1,LL,PM,80250,26750,107000,7/2/2024,User1
1483,18,1,LL,PM,80250,26750,107000,7/2/2024,User1
1484,18,1,LL,PM,80250,26750,107000,7/2/2024,User1
1485,18,1,LL,PM,80250,26750,107000,7/2/2024,User1
1486,18,1,LL,PM,80250,26750,107000,7/2/2024,User1
1487,18,1,LL,PM,80250,26750,107000,7/2/2024,User1
1488,18,1,LL,PM,80250,26750,107000,7/2/2024,User1
1489,18,1,LL,PM,80250,26750,107000,7/2/2024,User1
1490,18,1,LL,PM,80250,26750,107000,7/2/2024,User1
1491,18,1,LL,PM,80250,26750,107000,7/2/2024,User1
1492,18,1,LL,PM,80250,26750,107000,7/2/2024,User1
1493,18,1,LL,PM,80250,26750,107000,7/2/2024,User1
1494,18,1,LL,PM,80250,26750,107000,7/2/2024,User1
1495,18,1,LL,SP,86250,28750,115000,7/2/2024,User1
1496,18,1,LL,SP,86250,28750,115000,7/2/2024,User1
1497,18,1,LL,SP,86250,28750,115000,7/2/2024,User1
1498,18,1,LL,SP,86250,28750,115000,7/2/2024,User1
1499,18,1,LL,SP,86250,28750,115000,7/2/2024,User1
1500,18,1,LL,SP,86250,28750,115000,7/2/2024,User1
1501,18,1,LL,SP,86250,28750,115000,7/2/2024,User1
1502,18,1,LL,SP,86250,28750,115000,7/2/2024,User1
1503,18,1,LL,SP,86250,28750,115000,7/2/2024,User1
1504,18,1,LL,SP,86250,28750,115000,7/2/2024,User1
1505,18,1,LL,SP,86250,28750,115000,7/2/2024,User1
1506,18,1,LL,SP,86250,28750,115000,7/2/2024,User1
1507,18,1,LL,SP,86250,28750,115000,7/2/2024,User1
1508,18,1,LL,SP,86250,28750,115000,7/2/2024,User1
1509,18,1,LL,SP,86250,28750,115000,7/2/2024,User1
1510,18,1,LL,SP,86250,28750,115000,5/14/2024,User1
1511,18,1,LL,SP,86250,28750,115000,5/14/2024,User1
1512,18,1,LL,PR,94500,31500,126000,5/14/2024,User1
1513,18,1,LL,PR,94500,31500,126000,5/14/2024,User1
1514,18,1,LL,PR,94500,31500,126000,5/14/2024,User1
1515,18,1,LL,PR,94500,31500,126000,5/14/2024,User1
1516,18,1,LL,PR,94500,31500,126000,5/14/2024,User1
1517,18,1,LL,PR,94500,31500,126000,5/14/2024,User1
1518,18,1,LL,PR,94500,31500,126000,5/14/2024,User1
1519,18,1,LL,PR,94500,31500,126000,5/14/2024,User1
1520,18,1,LL,PR,94500,31500,126000,5/14/2024,User1
1521,18,1,LL,PR,94500,31500,126000,5/14/2024,User1
1522,18,1,LL,PR,94500,31500,126000,5/14/2024,User1
1523,18,1,LL,PR,94500,31500,126000,5/14/2024,User1
1524,18,1,LL,PR,94500,31500,126000,5/14/2024,User1
1525,18,1,LL,PR,94500,31500,126000,5/14/2024,User1
1526,18,1,LL,PR,94500,31500,126000,5/14/2024,User1
1527,18,1,LL,PR,94500,31500,126000,5/14/2024,User1
1528,18,1,LL,PR,94500,31500,126000,5/14/2024,User1
1529,18,1,LL-S,PM,80250,26750,107000,5/14/2024,User1
1530,18,1,LL-S,PM,80250,26750,107000,5/14/2024,User1
1531,18,1,LL-S,PM,80250,26750,107000,5/14/2024,User1
1532,18,1,LL-S,PM,80250,26750,107000,5/14/2024,User1
1533,18,1,LL-S,PM,80250,26750,107000,5/14/2024,User1
1534,18,1,LL-S,PM,80250,26750,107000,5/14/2024,User1
1535,18,1,LL-S,PM,80250,26750,107000,5/14/2024,User1
1536,18,1,LL-S,PM,80250,26750,107000,5/14/2024,User1
1537,18,1,LL-S,PM,80250,26750,107000,5/14/2024,User1
1538,18,1,LL-S,PM,80250,26750,107000,5/14/2024,User1
1539,18,1,LL-S,PM,80250,26750,107000,5/14/2024,User1
1540,18,1,LL-S,PM,80250,26750,107000,5/14/2024,User1
1541,18,1,LL-S,PM,80250,26750,107000,5/14/2024,User1
1542,18,1,LL-S,PM,80250,26750,107000,5/14/2024,User1
1543,18,1,LL-S,PM,80250,26750,107000,5/14/2024,User1
1544,18,1,LL-S,PM,80250,26750,107000,5/14/2024,User1
1545,18,1,LL-S,PM,80250,26750,107000,5/14/2024,User1
1546,18,1,LL-S,SP,86250,28750,115000,5/14/2024,User1
1547,18,1,LL-S,SP,86250,28750,115000,5/14/2024,User1
1548,18,1,LL-S,SP,86250,28750,115000,5/14/2024,User1
1549,18,1,LL-S,SP,86250,28750,115000,5/14/2024,User1
1550,18,1,LL-S,SP,86250,28750,115000,5/14/2024,User1
1551,18,1,LL-S,SP,86250,28750,115000,5/14/2024,User1
1552,18,1,LL-S,SP,86250,28750,115000,5/14/2024,User1
1553,18,1,LL-S,SP,86250,28750,115000,5/14/2024,User1
1554,18,1,LL-S,SP,86250,28750,115000,5/14/2024,User1
1555,18,1,LL-S,SP,86250,28750,115000,5/14/2024,User1
1556,18,1,LL-S,SP,86250,28750,115000,5/14/2024,User1
1557,18,1,LL-S,SP,86250,28750,115000,5/14/2024,User1
1558,18,1,LL-S,SP,86250,28750,115000,5/14/2024,User1
1559,18,1,LL-S,SP,86250,28750,115000,5/14/2024,User1
1560,18,1,LL-S,SP,86250,28750,115000,5/14/2024,User1
1561,18,1,LL-S,SP,86250,28750,115000,5/14/2024,User1
1562,18,1,LL-S,SP,86250,28750,115000,5/14/2024,User1
1563,18,1,LL-S,PR,94500,31500,126000,5/14/2024,User1
1564,18,1,LL-S,PR,94500,31500,126000,5/14/2024,User1
1565,18,1,LL-S,PR,94500,31500,126000,5/14/2024,User1
1566,18,1,LL-S,PR,94500,31500,126000,5/14/2024,User1
1567,18,1,LL-S,PR,94500,31500,126000,5/14/2024,User1
1568,18,1,LL-S,PR,94500,31500,126000,5/14/2024,User1
1569,18,1,LL-S,PR,94500,31500,126000,5/14/2024,User1
1570,18,1,LL-S,PR,94500,31500,126000,5/14/2024,User1
1571,18,1,LL-S,PR,94500,31500,126000,5/14/2024,User1
1572,18,1,LL-S,PR,94500,31500,126000,5/14/2024,User1
1573,18,1,LL-S,PR,94500,31500,126000,5/14/2024,User1
1574,18,1,LL-S,PR,94500,31500,126000,5/14/2024,User1
1575,18,1,LL-S,PR,94500,31500,126000,5/14/2024,User1
1576,18,1,LL-S,PR,94500,31500,126000,5/14/2024,User1
1577,18,1,LL-S,PR,94500,31500,126000,5/14/2024,User1
1578,18,1,LL-S,PR,94500,31500,126000,5/14/2024,User1
1579,18,1,LL-S,PR,94500,31500,126000,5/14/2024,User1
1580,18,1,FE,FE12-PM,1237500,412500,1650000,5/14/2024,User1
1581,18,1,FE,FE12-PM,1237500,412500,1650000,5/14/2024,User1
1582,18,1,FE,FE12-PM,1237500,412500,1650000,5/14/2024,User1
1583,18,1,FE,FE12-PM,1237500,412500,1650000,5/14/2024,User1
1584,18,1,FE,FE12-PM,1237500,412500,1650000,5/14/2024,User1
1585,18,1,FE,FE12-PM,1237500,412500,1650000,5/14/2024,User1
1586,18,1,FE,FE12-PM,1237500,412500,1650000,5/14/2024,User1
1587,18,1,FE,FE12-PM,1237500,412500,1650000,5/14/2024,User1
1588,18,1,FE,FE12-PM,1237500,412500,1650000,5/14/2024,User1
1589,18,1,FE,FE12-PM,1237500,412500,1650000,5/14/2024,User1
1590,18,1,FE,FE12-PM,1237500,412500,1650000,5/14/2024,User1
1591,18,1,FE,FE12-PM,1237500,412500,1650000,5/14/2024,User1
1592,18,1,FE,FE12-PM,1237500,412500,1650000,5/14/2024,User1
1593,18,1,FE,FE12-PM,1237500,412500,1650000,5/14/2024,User1
1594,18,1,FE,FE12-PM,1237500,412500,1650000,5/14/2024,User1
1595,18,1,FE,FE12-PM,1237500,412500,1650000,5/14/2024,User1
1596,18,1,FE,FE12-PM,1237500,412500,1650000,5/14/2024,User1
1597,18,1,LLO,PR,45750,15250,61000,5/14/2024,User1
1598,18,1,LLO,PR,45750,15250,61000,5/14/2024,User1
1599,18,1,LLO,PR,45750,15250,61000,5/14/2024,User1
1600,18,1,LLO,PR,45750,15250,61000,5/14/2024,User1
1601,18,1,LLO,PR,45750,15250,61000,5/14/2024,User1
1602,18,1,LLO,PR,45750,15250,61000,5/14/2024,User1
1603,18,1,LLO,PR,45750,15250,61000,5/14/2024,User1
1604,18,1,GP,PM,270000,90000,360000,5/14/2024,User1
1605,18,1,GP,PM,270000,90000,360000,5/14/2024,User1
1606,18,1,GP,PM,270000,90000,360000,5/14/2024,User1
1607,18,1,GP,PM,270000,90000,360000,5/14/2024,User1
1608,18,1,GP,PM,270000,90000,360000,5/14/2024,User1
1609,18,1,GP,PM,270000,90000,360000,5/14/2024,User1
1610,18,1,GP,PM,270000,90000,360000,5/14/2024,User1
1611,18,1,GP,PM,270000,90000,360000,5/14/2024,User1
1612,18,1,GP,PM,270000,90000,360000,5/14/2024,User1
1613,18,1,GP,PM,270000,90000,360000,5/14/2024,User1
1614,18,1,GP,PM,270000,90000,360000,5/14/2024,User1
1615,18,1,GP,PM,270000,90000,360000,5/14/2024,User1
1616,18,1,GP,PM,270000,90000,360000,5/14/2024,User1
1617,18,1,GP,PM,270000,90000,360000,5/14/2024,User1
1618,18,1,GP,PM,270000,90000,360000,5/14/2024,User1
1619,18,1,GP,PM,270000,90000,360000,5/14/2024,User1
1620,18,1,GP,PM,270000,90000,360000,5/14/2024,User1
1621,18,1,GP,SP,289500,96500,386000,5/14/2024,User1
1622,18,1,GP,SP,289500,96500,386000,5/14/2024,User1
1623,18,1,GP,SP,289500,96500,386000,5/14/2024,User1
1624,18,1,GP,SP,289500,96500,386000,5/14/2024,User1
1625,18,1,GP,SP,289500,96500,386000,5/14/2024,User1
1626,18,1,GP,SP,289500,96500,386000,5/14/2024,User1
1627,18,1,GP,SP,289500,96500,386000,5/14/2024,User1
1628,18,1,GP,SP,289500,96500,386000,5/14/2024,User1
1629,18,1,GP,SP,289500,96500,386000,5/14/2024,User1
1630,18,1,GP,SP,289500,96500,386000,5/14/2024,User1
1631,18,1,GP,SP,289500,96500,386000,5/14/2024,User1
1632,18,1,GP,SP,289500,96500,386000,5/14/2024,User1
1633,18,1,GP,SP,289500,96500,386000,5/14/2024,User1
1634,18,1,GP,SP,289500,96500,386000,5/14/2024,User1
1635,18,1,GP,SP,289500,96500,386000,5/14/2024,User1
1636,18,1,GP,SP,289500,96500,386000,5/14/2024,User1
1637,18,1,GP,SP,289500,96500,386000,5/14/2024,User1
1638,18,1,GP,PR,316500,105500,422000,5/14/2024,User1
1639,18,1,GP,PR,316500,105500,422000,5/14/2024,User1
1640,18,1,GP,PR,316500,105500,422000,5/14/2024,User1
1641,18,1,GP,PR,316500,105500,422000,5/14/2024,User1
1642,18,1,GP,PR,316500,105500,422000,5/14/2024,User1
1643,18,1,GP,PR,316500,105500,422000,5/14/2024,User1
1644,18,1,GP,PR,316500,105500,422000,5/14/2024,User1
1645,18,1,GP,PR,316500,105500,422000,5/14/2024,User1
1646,18,1,GP,PR,316500,105500,422000,5/14/2024,User1
1647,18,1,GP,PR,316500,105500,422000,5/14/2024,User1
1648,18,1,GP,PR,316500,105500,422000,5/14/2024,User1
1649,18,1,GP,PR,316500,105500,422000,5/14/2024,User1
1650,18,1,GP,PR,316500,105500,422000,5/14/2024,User1
1651,18,1,GP,PR,316500,105500,422000,5/14/2024,User1
1652,18,1,GP,PR,316500,105500,422000,5/14/2024,User1
1653,18,1,GP,PR,316500,105500,422000,5/14/2024,User1
1654,18,1,GP,PR,316500,105500,422000,5/14/2024,User1
1655,18,1,GP,PR,421500,140500,562000,5/14/2024,User1
1656,18,1,GP,PR,421500,140500,562000,5/14/2024,User1
1657,18,1,GP,PR,421500,140500,562000,5/14/2024,User1
1658,18,1,GP,PR,421500,140500,562000,5/14/2024,User1
1659,18,1,GP,PR,421500,140500,562000,5/14/2024,User1
1660,18,1,GP,PR,421500,140500,562000,5/14/2024,User1
1661,18,1,GP,PR,421500,140500,562000,5/14/2024,User1
1662,18,1,GP,PR,421500,140500,562000,5/14/2024,User1
1663,18,1,GP,PR,421500,140500,562000,5/14/2024,User1
1664,18,1,GP,PR,421500,140500,562000,5/14/2024,User1
1665,18,1,GP,PR,421500,140500,562000,5/14/2024,User1
1666,18,1,GP,PR,421500,140500,562000,5/14/2024,User1
1667,18,1,GP,PR,421500,140500,562000,5/14/2024,User1
1668,18,1,GP,PR,421500,140500,562000,5/14/2024,User1
1669,18,1,GP,PR,421500,140500,562000,5/14/2024,User1
1670,18,1,GP,PR,421500,140500,562000,5/14/2024,User1
1671,18,1,GP,PR,421500,140500,562000,5/14/2024,User1
1672,18,1,LL,PM,80250,26750,107000,5/14/2024,User1
1673,18,1,LL,PM,80250,26750,107000,5/14/2024,User1
1674,18,1,LL,PM,80250,26750,107000,5/14/2024,User1
1675,18,1,LL,PM,80250,26750,107000,5/14/2024,User1
1676,18,1,LL,PM,80250,26750,107000,5/14/2024,User1
1677,18,1,LL,PM,80250,26750,107000,5/14/2024,User1
1678,18,1,LL,PM,80250,26750,107000,5/14/2024,User1
1679,18,1,LL,PM,80250,26750,107000,5/14/2024,User1
1680,18,1,LL,PM,80250,26750,107000,5/14/2024,User1
1681,18,1,LL,PM,80250,26750,107000,5/14/2024,User1
1682,18,1,LL,PM,80250,26750,107000,5/14/2024,User1
1683,18,1,LL,PM,80250,26750,107000,5/14/2024,User1
1684,18,1,LL,PM,80250,26750,107000,5/14/2024,User1
1685,18,1,LL,PM,80250,26750,107000,5/14/2024,User1
1686,18,1,LL,PM,80250,26750,107000,5/14/2024,User1
1687,18,1,LL,PM,80250,26750,107000,5/14/2024,User1
1688,18,1,LL,PM,80250,26750,107000,5/14/2024,User1
1689,18,1,LL,SP,86250,28750,115000,5/14/2024,User1
1690,18,1,LL,SP,86250,28750,115000,5/14/2024,User1
1691,18,1,LL,SP,86250,28750,115000,5/14/2024,User1
1692,18,1,LL,SP,86250,28750,115000,5/14/2024,User1
1693,18,1,LL,SP,86250,28750,115000,5/14/2024,User1
1694,18,1,LL,SP,86250,28750,115000,5/14/2024,User1
1695,18,1,LL,SP,86250,28750,115000,5/14/2024,User1
1696,18,1,LL,SP,86250,28750,115000,5/14/2024,User1
1697,18,1,LL,SP,86250,28750,115000,5/14/2024,User1
1698,18,1,LL,SP,86250,28750,115000,5/14/2024,User1
1699,18,1,LL,SP,86250,28750,115000,5/14/2024,User1
1700,18,1,LL,SP,86250,28750,115000,5/14/2024,User1
1701,18,1,LL,SP,86250,28750,115000,5/14/2024,User1
1702,18,1,LL,SP,86250,28750,115000,5/14/2024,User1
1703,18,1,LL,SP,86250,28750,115000,5/14/2024,User1
1704,18,1,LL,PM,75000,25000,100000,4/2/2024,User1
1705,18,1,LL,PM,75000,25000,100000,4/2/2024,User1
1706,18,1,LL,PM,75000,25000,100000,4/2/2024,User1
1707,18,1,LL,PM,75000,25000,100000,4/2/2024,User1
1708,18,1,LL,PM,75000,25000,100000,4/2/2024,User1
1709,18,1,LL,PM,75000,25000,100000,4/2/2024,User1
1710,18,1,LL,PM,75000,25000,100000,4/2/2024,User1
1711,18,1,LL,PM,75000,25000,100000,4/2/2024,User1
1712,18,1,LL,PM,75000,25000,100000,4/2/2024,User1
1713,18,1,LL,SP,80250,26750,107000,4/2/2024,User1
1714,18,1,LL,SP,80250,26750,107000,4/2/2024,User1
1715,18,1,LL,SP,80250,26750,107000,4/2/2024,User1
1716,18,1,LL,SP,80250,26750,107000,4/2/2024,User1
1717,18,1,LL,SP,80250,26750,107000,4/2/2024,User1
1718,18,1,LL,SP,80250,26750,107000,4/2/2024,User1
1719,18,1,LL,SP,80250,26750,107000,4/2/2024,User1
1720,18,1,LL,SP,80250,26750,107000,4/2/2024,User1
1721,18,1,LL,SP,80250,26750,107000,4/2/2024,User1
1722,18,1,LL,SP,80250,26750,107000,4/2/2024,User1
1723,18,1,LL,SP,80250,26750,107000,4/2/2024,User1
1724,18,1,LL,SP,80250,26750,107000,4/2/2024,User1
1725,18,1,LL,SP,80250,26750,107000,4/2/2024,User1
1726,18,1,LL,SP,80250,26750,107000,4/2/2024,User1
1727,18,1,LL,SP,80250,26750,107000,4/2/2024,User1
1728,18,1,LL,PM,75000,25000,100000,2/1/2024,User1
1729,18,1,LL,PM,75000,25000,100000,2/1/2024,User1
1730,18,1,LL,PM,75000,25000,100000,2/1/2024,User1
1731,18,1,LL,PM,75000,25000,100000,2/1/2024,User1
1732,18,1,LL,PM,75000,25000,100000,2/1/2024,User1
1733,18,1,LL,PM,75000,25000,100000,2/1/2024,User1
1734,18,1,LL,PM,75000,25000,100000,2/1/2024,User1
1735,18,1,LL,PM,75000,25000,100000,2/1/2024,User1
1736,18,1,LL,PM,75000,25000,100000,2/1/2024,User1
1737,18,1,LL,PM,75000,25000,100000,2/1/2024,User1
1738,18,1,LL,PM,75000,25000,100000,2/1/2024,User1
1739,18,1,LL,PM,75000,25000,100000,2/1/2024,User1
1740,18,1,LL,PM,75000,25000,100000,2/1/2024,User1
1741,18,1,LL,PM,75000,25000,100000,2/1/2024,User1
1742,18,1,LL,PM,75000,25000,100000,2/1/2024,User1
1743,18,1,LL,SP,80250,26750,107000,2/1/2024,User1
1744,18,1,LL,SP,80250,26750,107000,2/1/2024,User1
1745,18,1,LL,SP,80250,26750,107000,2/1/2024,User1
1746,18,1,LL,SP,80250,26750,107000,2/1/2024,User1
1747,18,1,LL,SP,80250,26750,107000,2/1/2024,User1
1748,18,1,LL,SP,80250,26750,107000,2/1/2024,User1
1749,18,1,LL,SP,80250,26750,107000,2/1/2024,User1
1750,18,1,LL,SP,80250,26750,107000,2/1/2024,User1
1751,18,1,LL,SP,80250,26750,107000,2/1/2024,User1
1752,18,1,LL,SP,80250,26750,107000,2/1/2024,User1
1753,18,1,LL,SP,80250,26750,107000,2/1/2024,User1
1754,18,1,LL,SP,80250,26750,107000,2/1/2024,User1
1755,18,1,LL,SP,80250,26750,107000,2/1/2024,User1
1756,18,1,LL,SP,80250,26750,107000,2/1/2024,User1
1757,18,1,LL,SP,80250,26750,107000,2/1/2024,User1
1758,18,1,LL,SP,80250,26750,107000,2/1/2024,User1
1759,18,1,LL,PR,87750,29250,117000,2/1/2024,User1
1760,18,1,LL,PR,87750,29250,117000,2/1/2024,User1
1761,18,1,LL,PR,87750,29250,117000,2/1/2024,User1
1762,18,1,LL,PR,87750,29250,117000,2/1/2024,User1
1763,18,1,LL,PR,87750,29250,117000,2/1/2024,User1
1764,18,1,LL,PR,87750,29250,117000,2/1/2024,User1
1765,18,1,LL,PR,87750,29250,117000,2/1/2024,User1
1766,18,1,LL,PR,87750,29250,117000,2/1/2024,User1
1767,18,1,LL,PR,87750,29250,117000,2/1/2024,User1
1768,18,1,LL,PR,87750,29250,117000,2/1/2024,User1
1769,18,1,LL,PR,87750,29250,117000,2/1/2024,User1
1770,18,1,LL,PR,87750,29250,117000,2/1/2024,User1
1771,18,1,LL,PR,87750,29250,117000,2/1/2024,User1
1772,18,1,LL,PR,87750,29250,117000,2/1/2024,User1
1773,18,1,LL,PR,87750,29250,117000,2/1/2024,User1
1774,18,1,LL,PR,87750,29250,117000,2/1/2024,User1
1775,18,1,LL-S,PM,75000,25000,100000,2/1/2024,User1
1776,18,1,LL-S,PM,75000,25000,100000,2/1/2024,User1
1777,18,1,LL-S,PM,75000,25000,100000,2/1/2024,User1
1778,18,1,LL-S,PM,75000,25000,100000,2/1/2024,User1
1779,18,1,LL-S,PM,75000,25000,100000,2/1/2024,User1
1780,18,1,LL-S,PM,75000,25000,100000,2/1/2024,User1
1781,18,1,LL-S,PM,75000,25000,100000,2/1/2024,User1
1782,18,1,LL-S,PM,75000,25000,100000,2/1/2024,User1
1783,18,1,LL-S,PM,75000,25000,100000,2/1/2024,User1
1784,18,1,LL-S,PM,75000,25000,100000,2/1/2024,User1
1785,18,1,LL-S,PM,75000,25000,100000,2/1/2024,User1
1786,18,1,LL-S,PM,75000,25000,100000,2/1/2024,User1
1787,18,1,LL-S,PM,75000,25000,100000,2/1/2024,User1
1788,18,1,LL-S,PM,75000,25000,100000,2/1/2024,User1
1789,18,1,LL-S,PM,75000,25000,100000,2/1/2024,User1
1790,18,1,LL,PM,75000,25000,100000,2/1/2024,User1
1791,18,1,LL-S,PM,75000,25000,100000,2/1/2024,User1
1792,18,1,LL-S,PM,75000,25000,100000,2/1/2024,User1
1793,18,1,LL-S,SP,80250,26750,107000,2/1/2024,User1
1794,18,1,LL-S,SP,80250,26750,107000,2/1/2024,User1
1795,18,1,LL-S,SP,80250,26750,107000,2/1/2024,User1
1796,18,1,LL-S,SP,80250,26750,107000,2/1/2024,User1
1797,18,1,LL-S,SP,80250,26750,107000,2/1/2024,User1
1798,18,1,LL-S,SP,80250,26750,107000,2/1/2024,User1
1799,18,1,LL-S,SP,80250,26750,107000,2/1/2024,User1
1800,18,1,LL-S,SP,80250,26750,107000,2/1/2024,User1
1801,18,1,LL-S,SP,80250,26750,107000,2/1/2024,User1
1802,18,1,LL-S,SP,80250,26750,107000,2/1/2024,User1
1803,18,1,LL-S,SP,80250,26750,107000,2/1/2024,User1
1804,18,1,LL-S,SP,80250,26750,107000,2/1/2024,User1
1805,18,1,LL-S,SP,80250,26750,107000,2/1/2024,User1
1806,18,1,LL-S,SP,80250,26750,107000,2/1/2024,User1
1807,18,1,LL-S,SP,80250,26750,107000,2/1/2024,User1
1808,18,1,LL-S,SP,80250,26750,107000,2/1/2024,User1
1809,18,1,LL-S,PR,87750,29250,117000,2/1/2024,User1
1810,18,1,LL-S,PR,87750,29250,117000,2/1/2024,User1
1811,18,1,LL-S,PR,87750,29250,117000,2/1/2024,User1
1812,18,1,LL-S,PR,87750,29250,117000,2/1/2024,User1
1813,18,1,LL-S,PR,87750,29250,117000,2/1/2024,User1
1814,18,1,LL-S,PR,87750,29250,117000,2/1/2024,User1
1815,18,1,LL-S,PR,87750,29250,117000,2/1/2024,User1
1816,18,1,LL-S,PR,87750,29250,117000,2/1/2024,User1
1817,18,1,LL-S,PR,87750,29250,117000,2/1/2024,User1
1818,18,1,LL-S,PR,87750,29250,117000,2/1/2024,User1
1819,18,1,LL-S,PR,87750,29250,117000,2/1/2024,User1
1820,18,1,LL-S,PR,87750,29250,117000,2/1/2024,User1
1821,18,1,LL-S,PR,87750,29250,117000,2/1/2024,User1
1822,18,1,LL-S,PR,87750,29250,117000,2/1/2024,User1
1823,18,1,LL-S,PR,87750,29250,117000,2/1/2024,User1
1824,18,1,FE,FE12-PM,1125000,375000,1500000,2/1/2024,User1
1825,18,1,FE,FE12-PM,1125000,375000,1500000,2/1/2024,User1
1826,18,1,FE,FE12-PM,1125000,375000,1500000,2/1/2024,User1
1827,18,1,FE,FE12-PM,1125000,375000,1500000,2/1/2024,User1
1828,18,1,FE,FE12-PM,1125000,375000,1500000,2/1/2024,User1
1829,18,1,FE,FE12-PM,1125000,375000,1500000,2/1/2024,User1
1830,18,1,FE,FE12-PM,1125000,375000,1500000,2/1/2024,User1
1831,18,1,FE,FE12-PM,1125000,375000,1500000,2/1/2024,User1
1832,18,1,FE,FE12-PM,1125000,375000,1500000,2/1/2024,User1
1833,18,1,FE,FE12-PM,1125000,375000,1500000,2/1/2024,User1
1834,18,1,FE,FE12-PM,1125000,375000,1500000,2/1/2024,User1
1835,18,1,FE,FE12-PM,1125000,375000,1500000,2/1/2024,User1
1836,18,1,FE,FE12-PM,1125000,375000,1500000,2/1/2024,User1
1837,18,1,FE,FE12-PM,1125000,375000,1500000,2/1/2024,User1
1838,18,1,FE,FE19-PM,1781250,593750,2375000,2/1/2024,User1
1839,18,1,FE,FE19-PM,1781250,593750,2375000,2/1/2024,User1
1840,18,1,FE,FE19-PM,1781250,593750,2375000,2/1/2024,User1
1841,18,1,FE,FE19-PM,1781250,593750,2375000,2/1/2024,User1
1842,18,1,FE,FE19-PM,1781250,593750,2375000,2/1/2024,User1
1843,18,1,FE,FE19-PM,1781250,593750,2375000,2/1/2024,User1
1844,18,1,FE,FE19-PM,1781250,593750,2375000,2/1/2024,User1
1845,18,1,FE,FE19-PM,1781250,593750,2375000,2/1/2024,User1
1846,18,1,FE,FE19-PM,1781250,593750,2375000,2/1/2024,User1
1847,18,1,FE,FE19-PM,1781250,593750,2375000,2/1/2024,User1
1848,18,1,FE,FE19-PM,1781250,593750,2375000,2/1/2024,User1
1849,18,1,FE,FE19-PM,1781250,593750,2375000,2/1/2024,User1
1850,18,1,GP,PR,421500,140500,562000,4/1/2024,User1
1851,18,1,GP,PR,421500,140500,562000,4/1/2024,User1
1852,18,1,GP,PR,421500,140500,562000,4/1/2024,User1
1853,18,1,GP,PR,421500,140500,562000,4/1/2024,User1
1854,18,1,GP,PR,421500,140500,562000,4/1/2024,User1
1855,18,1,GP,PR,421500,140500,562000,4/1/2024,User1
1856,18,1,GP,PR,421500,140500,562000,4/1/2024,User1
1857,18,1,GP,PR,421500,140500,562000,4/1/2024,User1
1858,18,1,GP,PR,421500,140500,562000,4/1/2024,User1
1859,18,1,GP,PR,421500,140500,562000,4/1/2024,User1
1860,18,1,GP,PR,421500,140500,562000,4/1/2024,User1
1861,18,1,GP,PR,421500,140500,562000,4/1/2024,User1
1862,18,1,GP,PR,421500,140500,562000,4/1/2024,User1
1863,18,1,GP,PR,421500,140500,562000,4/1/2024,User1
1864,18,1,GP,PR,421500,140500,562000,4/1/2024,User1
1865,18,1,GP,PR,421500,140500,562000,4/1/2024,User1
1866,18,1,GP,PR,421500,140500,562000,4/1/2024,User1
1867,18,1,LL,PM,75000,25000,100000,4/1/2024,User1
1868,18,1,LL,PM,75000,25000,100000,4/1/2024,User1
1869,18,1,LL,PM,75000,25000,100000,4/1/2024,User1
1870,18,1,LL,PM,75000,25000,100000,4/1/2024,User1
1871,18,1,LL,PM,75000,25000,100000,4/1/2024,User1
1872,18,1,LL,PM,75000,25000,100000,4/1/2024,User1
1873,18,1,LL,PM,75000,25000,100000,4/1/2024,User1
1874,18,1,LL,PM,75000,25000,100000,4/1/2024,User1
1875,18,1,LL,PM,75000,25000,100000,4/1/2024,User1
1876,18,1,LL,PM,75000,25000,100000,4/1/2024,User1
1877,18,1,LL,PM,75000,25000,100000,4/1/2024,User1
1878,18,1,LL,PM,75000,25000,100000,4/1/2024,User1
1879,18,1,LL,PM,75000,25000,100000,4/1/2024,User1
1880,18,1,LL,PM,75000,25000,100000,4/1/2024,User1
1881,18,1,LL,PM,75000,25000,100000,4/1/2024,User1
1882,18,1,LL,PM,75000,25000,100000,4/1/2024,User1
1883,18,1,LL,PM,75000,25000,100000,4/1/2024,User1
1884,18,1,LL,SP,80250,26750,107000,4/1/2024,User1
1885,18,1,LL,SP,80250,26750,107000,4/1/2024,User1
1886,18,1,LL,SP,80250,26750,107000,4/1/2024,User1
1887,18,1,LL,SP,80250,26750,107000,4/1/2024,User1
1888,18,1,LL,SP,80250,26750,107000,4/1/2024,User1
1889,18,1,LL,SP,80250,26750,107000,4/1/2024,User1
1890,18,1,LL,SP,80250,26750,107000,4/1/2024,User1
1891,18,1,LL,SP,80250,26750,107000,4/1/2024,User1
1892,18,1,LL,SP,80250,26750,107000,4/1/2024,User1
1893,18,1,LL,SP,80250,26750,107000,4/1/2024,User1
1894,18,1,LL,SP,80250,26750,107000,4/1/2024,User1
1895,18,1,LL,SP,80250,26750,107000,4/1/2024,User1
1896,18,1,LL,SP,80250,26750,107000,4/1/2024,User1
1897,18,1,LL,SP,80250,26750,107000,4/1/2024,User1
1898,18,1,LL,SP,80250,26750,107000,4/1/2024,User1
1899,18,1,LL,SP,80250,26750,107000,4/1/2024,User1
1900,18,1,LL,SP,80250,26750,107000,4/1/2024,User1
1901,18,1,LL,PR,87750,29250,117000,4/1/2024,User1
1902,18,1,LL,PR,87750,29250,117000,4/1/2024,User1
1903,18,1,LL,PR,87750,29250,117000,4/1/2024,User1
1904,18,1,LL,PR,87750,29250,117000,4/1/2024,User1
1905,18,1,LL,PR,87750,29250,117000,4/1/2024,User1
1906,18,1,LL,PR,87750,29250,117000,4/1/2024,User1
1907,18,1,LL,PR,87750,29250,117000,4/1/2024,User1
1908,18,1,LL,PR,87750,29250,117000,4/1/2024,User1
1909,18,1,LL,PR,87750,29250,117000,4/1/2024,User1
1910,18,1,LL,PR,87750,29250,117000,4/1/2024,User1
1911,18,1,LL,PR,87750,29250,117000,4/1/2024,User1
1912,18,1,LL,PR,87750,29250,117000,4/1/2024,User1
1913,18,1,LL,PR,87750,29250,117000,4/1/2024,User1
1914,18,1,LL,PR,87750,29250,117000,4/1/2024,User1
1915,18,1,LL,PR,87750,29250,117000,4/1/2024,User1
1916,18,1,LL,PR,87750,29250,117000,4/1/2024,User1
1917,18,1,LL,PR,87750,29250,117000,4/1/2024,User1
1918,18,1,LL-S,PM,75000,25000,100000,4/1/2024,User1
1919,18,1,LL-S,PM,75000,25000,100000,4/1/2024,User1
1920,18,1,LL-S,PM,75000,25000,100000,4/1/2024,User1
1921,18,1,LL-S,PM,75000,25000,100000,4/1/2024,User1
1922,18,1,LL-S,PM,75000,25000,100000,4/1/2024,User1
1923,18,1,LL-S,PM,75000,25000,100000,4/1/2024,User1
1924,18,1,LL-S,PM,75000,25000,100000,4/1/2024,User1
1925,18,1,LL-S,PM,75000,25000,100000,4/1/2024,User1
1926,18,1,LL-S,PM,75000,25000,100000,4/1/2024,User1
1927,18,1,LL-S,PM,75000,25000,100000,4/1/2024,User1
1928,18,1,LL-S,PM,75000,25000,100000,4/1/2024,User1
1929,18,1,LL-S,PM,75000,25000,100000,4/1/2024,User1
1930,18,1,LL-S,PM,75000,25000,100000,4/1/2024,User1
1931,18,1,LL-S,PM,75000,25000,100000,4/1/2024,User1
1932,18,1,LL-S,PM,75000,25000,100000,4/1/2024,User1
1933,18,1,LL-S,PM,75000,25000,100000,4/1/2024,User1
1934,18,1,LL-S,PM,75000,25000,100000,4/1/2024,User1
1935,18,1,LL-S,SP,80250,26750,107000,4/1/2024,User1
1936,18,1,LL-S,SP,80250,26750,107000,4/1/2024,User1
1937,18,1,LL-S,SP,80250,26750,107000,4/1/2024,User1
1938,18,1,LL-S,SP,80250,26750,107000,4/1/2024,User1
1939,18,1,LL-S,SP,80250,26750,107000,4/1/2024,User1
1940,18,1,LL-S,SP,80250,26750,107000,4/1/2024,User1
1941,18,1,LL-S,SP,80250,26750,107000,4/1/2024,User1
1942,18,1,LL-S,SP,80250,26750,107000,4/1/2024,User1
1943,18,1,LL-S,SP,80250,26750,107000,4/1/2024,User1
1944,18,1,LL-S,SP,80250,26750,107000,4/1/2024,User1
1945,18,1,LL-S,SP,80250,26750,107000,4/1/2024,User1
1946,18,1,LL-S,SP,80250,26750,107000,4/1/2024,User1
1947,18,1,FE,FE19-PM,1781250,593750,2375000,4/26/2024,User1
1948,18,1,FE,FE19-PM,1781250,593750,2375000,4/26/2024,User1
1949,18,1,FE,FE19-PM,1781250,593750,2375000,4/26/2024,User1
1950,18,1,FE,FE19-PM,1781250,593750,2375000,4/26/2024,User1
1951,18,1,FE,FE19-PM,1781250,593750,2375000,4/26/2024,User1
1952,18,1,FE,FE19-PM,1781250,593750,2375000,4/26/2024,User1
1953,18,1,FE,FE19-PM,1781250,593750,2375000,4/26/2024,User1
1954,18,1,FE,FE19-PM,1781250,593750,2375000,4/26/2024,User1
1955,18,1,FE,FE19-PM,1781250,593750,2375000,4/26/2024,User1
1956,18,1,FE,FE19-PM,1781250,593750,2375000,4/26/2024,User1
1957,18,1,FE,FE19-PM,1781250,593750,2375000,4/26/2024,User1
1958,18,1,FE,FE19-PM,1781250,593750,2375000,4/26/2024,User1
1959,18,1,FE,FE19-PM,1781250,593750,2375000,4/26/2024,User1
1960,18,1,FE,FE19-PM,1781250,593750,2375000,4/26/2024,User1
1961,18,1,LLO,PR,45750,15250,61000,4/26/2024,User1
1962,18,1,LLO,PR,45750,15250,61000,4/26/2024,User1
1963,18,1,LLO,PR,45750,15250,61000,4/26/2024,User1
1964,18,1,GP,PR,316500,105500,422000,4/26/2024,User1
1965,18,1,GP,PR,316500,105500,422000,4/26/2024,User1
1966,18,1,GP,PR,316500,105500,422000,4/26/2024,User1
1967,18,1,GP,PR,316500,105500,422000,4/26/2024,User1
1968,18,1,GP,PR,316500,105500,422000,4/26/2024,User1
1969,18,1,GP,PM,270000,90000,360000,4/26/2024,User1
1970,18,1,GP,PM,270000,90000,360000,4/26/2024,User1
1971,18,1,GP,PM,270000,90000,360000,4/26/2024,User1
1972,18,1,GP,PM,270000,90000,360000,4/26/2024,User1
1973,18,1,GP,PM,270000,90000,360000,4/26/2024,User1
1974,18,1,GP,PM,270000,90000,360000,4/26/2024,User1
1975,18,1,GP,PM,270000,90000,360000,4/26/2024,User1
1976,18,1,GP,PM,270000,90000,360000,4/26/2024,User1
1977,18,1,GP,PM,270000,90000,360000,4/26/2024,User1
1978,18,1,GP,PM,270000,90000,360000,4/26/2024,User1
1979,18,1,GP,PM,270000,90000,360000,4/26/2024,User1
1980,18,1,GP,PM,270000,90000,360000,4/26/2024,User1
1981,18,1,GP,SP,289500,96500,386000,4/26/2024,User1
1982,18,1,GP,SP,289500,96500,386000,4/26/2024,User1
1983,18,1,GP,SP,289500,96500,386000,4/26/2024,User1
1984,18,1,GP,SP,289500,96500,386000,4/26/2024,User1
1985,18,1,GP,SP,289500,96500,386000,4/26/2024,User1
1986,18,1,GP,SP,289500,96500,386000,4/26/2024,User1
1987,18,1,GP,SP,289500,96500,386000,4/26/2024,User1
1988,18,1,GP,SP,289500,96500,386000,4/26/2024,User1
1989,18,1,GP,SP,289500,96500,386000,4/26/2024,User1
1990,18,1,GP,SP,289500,96500,386000,4/26/2024,User1
1991,18,1,GP,SP,289500,96500,386000,4/26/2024,User1
1992,18,1,GP,SP,289500,96500,386000,4/26/2024,User1
1993,18,1,GP,SP,289500,96500,386000,4/26/2024,User1
1994,18,1,GP,SP,289500,96500,386000,4/26/2024,User1
1995,18,1,GP,SP,289500,96500,386000,4/26/2024,User1
1996,18,1,GP,SP,289500,96500,386000,4/26/2024,User1
1997,18,1,GP,SP,289500,96500,386000,4/26/2024,User1
1998,18,1,GP,PR,316500,105500,422000,4/26/2024,User1
1999,18,1,GP,PR,316500,105500,422000,4/26/2024,User1
2000,18,1,GP,PR,316500,105500,422000,4/26/2024,User1
2001,18,1,GP,PR,316500,105500,422000,4/26/2024,User1
2002,18,1,GP,PR,316500,105500,422000,4/26/2024,User1
2003,18,1,GP,PR,316500,105500,422000,4/26/2024,User1
2004,18,1,GP,PR,316500,105500,422000,4/26/2024,User1
2005,18,1,GP,PR,316500,105500,422000,4/26/2024,User1
2006,18,1,GP,PR,316500,105500,422000,4/26/2024,User1
2007,18,1,GP,PR,316500,105500,422000,4/26/2024,User1
2008,18,1,GP,PR,316500,105500,422000,4/26/2024,User1
2009,18,1,GP,PR,316500,105500,422000,4/26/2024,User1
2010,18,1,GP,PR,316500,105500,422000,4/26/2024,User1
2011,18,1,GP,PR,316500,105500,422000,4/26/2024,User1
2012,18,1,GP,PR,316500,105500,422000,4/26/2024,User1
2013,18,1,GP,PR,316500,105500,422000,4/26/2024,User1
2014,18,1,GP,PR,316500,105500,422000,4/26/2024,User1
2015,18,1,GP,PR,421500,140500,562000,4/26/2024,User1
2016,18,1,GP,PR,421500,140500,562000,4/26/2024,User1
2017,18,1,GP,PR,421500,140500,562000,4/26/2024,User1
2018,18,1,GP,PR,421500,140500,562000,4/26/2024,User1
2019,18,1,GP,PR,421500,140500,562000,4/26/2024,User1
2020,18,1,GP,PR,421500,140500,562000,4/26/2024,User1
2021,18,1,GP,PR,421500,140500,562000,4/26/2024,User1
2022,18,1,GP,PR,421500,140500,562000,4/26/2024,User1
2023,18,1,GP,PR,421500,140500,562000,4/26/2024,User1
2024,18,1,GP,PR,421500,140500,562000,4/26/2024,User1
2025,18,1,GP,PR,421500,140500,562000,4/26/2024,User1
2026,18,1,GP,PR,421500,140500,562000,4/26/2024,User1
2027,18,1,GP,PR,421500,140500,562000,4/26/2024,User1
2028,18,1,GP,PR,421500,140500,562000,4/26/2024,User1
2029,18,1,GP,PR,421500,140500,562000,4/26/2024,User1
2030,18,1,GP,PR,421500,140500,562000,4/26/2024,User1
2031,18,1,GP,PR,421500,140500,562000,4/26/2024,User1
2032,18,1,LL,PM,75000,25000,100000,4/26/2024,User1
2033,18,1,LL,PM,75000,25000,100000,4/26/2024,User1
2034,18,1,LL,PM,75000,25000,100000,4/26/2024,User1
2035,18,1,LL,PM,75000,25000,100000,4/26/2024,User1
2036,18,1,LL,PM,75000,25000,100000,4/26/2024,User1
2037,18,1,LL,PM,75000,25000,100000,4/26/2024,User1
2038,18,1,LL,PM,75000,25000,100000,4/26/2024,User1
2039,18,1,LL,PM,75000,25000,100000,4/26/2024,User1
2040,18,1,LL,PM,75000,25000,100000,4/26/2024,User1
2041,18,1,LL,PM,75000,25000,100000,4/26/2024,User1
2042,18,1,LL,PM,75000,25000,100000,4/26/2024,User1
2043,18,1,LL,PM,75000,25000,100000,4/26/2024,User1
2044,18,1,LL,PM,75000,25000,100000,4/26/2024,User1
2045,18,1,LL,PM,75000,25000,100000,4/26/2024,User1
2046,18,1,LL,PM,75000,25000,100000,4/26/2024,User1
2047,18,1,LL,PM,75000,25000,100000,4/26/2024,User1
2048,18,1,LL,PM,75000,25000,100000,4/26/2024,User1
2049,18,1,LL,SP,80250,26750,107000,4/26/2024,User1
2050,18,1,LL,SP,80250,26750,107000,4/26/2024,User1
2051,18,1,LL,SP,80250,26750,107000,4/26/2024,User1
2052,18,1,LL,SP,80250,26750,107000,4/26/2024,User1
2053,18,1,LL,SP,80250,26750,107000,4/26/2024,User1
2054,18,1,LL,SP,80250,26750,107000,4/26/2024,User1
2055,18,1,LL,SP,80250,26750,107000,4/26/2024,User1
2056,18,1,LL,SP,80250,26750,107000,4/26/2024,User1
2057,18,1,LL,SP,80250,26750,107000,4/26/2024,User1
2058,18,1,LL,SP,80250,26750,107000,4/26/2024,User1
2059,18,1,LL,SP,80250,26750,107000,4/26/2024,User1
2060,18,1,LL,SP,80250,26750,107000,4/26/2024,User1
2061,18,1,LL,SP,80250,26750,107000,4/26/2024,User1
2062,18,1,LL,SP,80250,26750,107000,4/26/2024,User1
2063,18,1,LL,SP,80250,26750,107000,4/26/2024,User1
2064,18,1,FE,FE19-PM,1781250,593750,2375000,2/1/2024,User1
2065,18,1,FE,FE19-PM,1781250,593750,2375000,2/1/2024,User1
2066,18,1,FE,FE19-PM,1781250,593750,2375000,2/1/2024,User1
2067,18,1,LL-S,SP,80250,26750,107000,4/1/2024,User1
2068,18,1,LL-S,SP,80250,26750,107000,4/1/2024,User1
2069,18,1,LL-S,SP,80250,26750,107000,4/1/2024,User1
2070,18,1,LL-S,SP,80250,26750,107000,4/1/2024,User1
2071,18,1,LL-S,SP,80250,26750,107000,4/1/2024,User1
2072,18,1,LL-S,PR,87750,29250,117000,4/1/2024,User1
2073,18,1,LL-S,PR,87750,29250,117000,4/1/2024,User1
2074,18,1,LL-S,PR,87750,29250,117000,4/1/2024,User1
2075,18,1,LL-S,PR,87750,29250,117000,4/1/2024,User1
2076,18,1,LL-S,PR,87750,29250,117000,4/1/2024,User1
2077,18,1,LL-S,PR,87750,29250,117000,4/1/2024,User1
2078,18,1,LL-S,PR,87750,29250,117000,4/1/2024,User1
2079,18,1,LL-S,PR,87750,29250,117000,4/1/2024,User1
2080,18,1,LL-S,PR,87750,29250,117000,4/1/2024,User1
2081,18,1,LL-S,PR,87750,29250,117000,4/1/2024,User1
2082,18,1,LL-S,PR,87750,29250,117000,4/1/2024,User1
2083,18,1,LL-S,PR,87750,29250,117000,4/1/2024,User1
2084,18,1,LL-S,PR,87750,29250,117000,4/1/2024,User1
2085,18,1,LL-S,PR,87750,29250,117000,4/1/2024,User1
2086,18,1,LL-S,PR,87750,29250,117000,4/1/2024,User1
2087,18,1,LL-S,PR,87750,29250,117000,4/1/2024,User1
2088,18,1,LL-S,PR,87750,29250,117000,4/1/2024,User1
2089,18,1,FE,FE12-PM,1125000,375000,1500000,4/1/2024,User1
2090,18,1,FE,FE12-PM,1125000,375000,1500000,4/1/2024,User1
2091,18,1,FE,FE12-PM,1125000,375000,1500000,4/1/2024,User1
2092,18,1,FE,FE12-PM,1125000,375000,1500000,4/1/2024,User1
2093,18,1,FE,FE12-PM,1125000,375000,1500000,4/1/2024,User1
2094,18,1,FE,FE12-PM,1125000,375000,1500000,4/1/2024,User1
2095,18,1,FE,FE12-PM,1125000,375000,1500000,4/1/2024,User1
2096,18,1,FE,FE12-PM,1125000,375000,1500000,4/1/2024,User1
2097,18,1,FE,FE12-PM,1125000,375000,1500000,4/1/2024,User1
2098,18,1,FE,FE12-PM,1125000,375000,1500000,4/1/2024,User1
2099,18,1,FE,FE12-PM,1125000,375000,1500000,4/1/2024,User1
2100,18,1,FE,FE12-PM,1125000,375000,1500000,4/1/2024,User1
2101,18,1,FE,FE12-PM,1125000,375000,1500000,4/1/2024,User1
2102,18,1,FE,FE12-PM,1125000,375000,1500000,4/1/2024,User1
2103,18,1,FE,FE12-PM,1125000,375000,1500000,4/1/2024,User1
2104,18,1,FE,FE12-PM,1125000,375000,1500000,4/1/2024,User1
2105,18,1,FE,FE19-PM,1781250,593750,2375000,4/1/2024,User1
2106,18,1,FE,FE19-PM,1781250,593750,2375000,4/1/2024,User1
2107,18,1,FE,FE19-PM,1781250,593750,2375000,4/1/2024,User1
2108,18,1,FE,FE19-PM,1781250,593750,2375000,4/1/2024,User1
2109,18,1,FE,FE19-PM,1781250,593750,2375000,4/1/2024,User1
2110,18,1,FE,FE19-PM,1781250,593750,2375000,4/1/2024,User1
2111,18,1,FE,FE19-PM,1781250,593750,2375000,4/1/2024,User1
2112,18,1,FE,FE19-PM,1781250,593750,2375000,4/1/2024,User1
2113,18,1,FE,FE19-PM,1781250,593750,2375000,4/1/2024,User1
2114,18,1,FE,FE19-PM,1781250,593750,2375000,4/1/2024,User1
2115,18,1,FE,FE19-PM,1781250,593750,2375000,4/1/2024,User1
2116,18,1,FE,FE19-PM,1781250,593750,2375000,4/1/2024,User1
2117,18,1,FE,FE19-PM,1781250,593750,2375000,4/1/2024,User1
2118,18,1,FE,FE19-PM,1781250,593750,2375000,4/1/2024,User1
2119,18,1,FE,FE19-PM,1781250,593750,2375000,4/1/2024,User1
2120,18,1,FE,FE19-PM,1781250,593750,2375000,4/1/2024,User1
2121,18,1,FE,FE19-PM,1781250,593750,2375000,4/1/2024,User1
2122,18,1,FE,FE19-PM,1781250,593750,2375000,4/1/2024,User1
2123,18,1,FE,FE19-PM,1781250,593750,2375000,4/1/2024,User1
2124,18,1,LLO,PR,45750,15250,61000,4/1/2024,User1
2125,18,1,LLO,PR,45750,15250,61000,4/1/2024,User1
2126,18,1,LLO,PR,45750,15250,61000,4/1/2024,User1
2127,18,1,LLO,PR,45750,15250,61000,4/1/2024,User1
2128,18,1,LLO,PR,45750,15250,61000,4/1/2024,User1
2129,18,1,LLO,PR,45750,15250,61000,4/1/2024,User1
2130,18,1,LLO,PR,45750,15250,61000,4/1/2024,User1
2131,18,1,LLO,PR,45750,15250,61000,4/1/2024,User1
2132,18,1,GP,PM,270000,90000,360000,4/1/2024,User1
2133,18,1,GP,PM,270000,90000,360000,4/1/2024,User1
2134,18,1,GP,PM,270000,90000,360000,4/1/2024,User1
2135,18,1,GP,PM,270000,90000,360000,4/1/2024,User1
2136,18,1,GP,PM,270000,90000,360000,4/1/2024,User1
2137,18,1,GP,PM,270000,90000,360000,4/1/2024,User1
2138,18,1,GP,PM,270000,90000,360000,4/1/2024,User1
2139,18,1,GP,PM,270000,90000,360000,4/1/2024,User1
2140,18,1,GP,PM,270000,90000,360000,4/1/2024,User1
2141,18,1,GP,PM,270000,90000,360000,4/1/2024,User1
2142,18,1,GP,PM,270000,90000,360000,4/1/2024,User1
2143,18,1,GP,PM,270000,90000,360000,4/1/2024,User1
2144,18,1,GP,SP,289500,96500,386000,4/1/2024,User1
2145,18,1,GP,SP,289500,96500,386000,4/1/2024,User1
2146,18,1,GP,SP,289500,96500,386000,4/1/2024,User1
2147,18,1,GP,SP,289500,96500,386000,4/1/2024,User1
2148,18,1,GP,SP,289500,96500,386000,4/1/2024,User1
2149,18,1,GP,SP,289500,96500,386000,4/1/2024,User1
2150,18,1,GP,SP,289500,96500,386000,4/1/2024,User1
2151,18,1,GP,SP,289500,96500,386000,4/1/2024,User1
2152,18,1,GP,SP,289500,96500,386000,4/1/2024,User1
2153,18,1,GP,SP,289500,96500,386000,4/1/2024,User1
2154,18,1,GP,SP,289500,96500,386000,4/1/2024,User1
2155,18,1,GP,SP,289500,96500,386000,4/1/2024,User1
2156,18,1,GP,SP,289500,96500,386000,4/1/2024,User1
2157,18,1,GP,SP,289500,96500,386000,4/1/2024,User1
2158,18,1,GP,SP,289500,96500,386000,4/1/2024,User1
2159,18,1,GP,SP,289500,96500,386000,4/1/2024,User1
2160,18,1,GP,SP,289500,96500,386000,4/1/2024,User1
2161,18,1,GP,PR,316500,105500,422000,4/1/2024,User1
2162,18,1,GP,PR,316500,105500,422000,4/1/2024,User1
2163,18,1,GP,PR,316500,105500,422000,4/1/2024,User1
2164,18,1,GP,PR,316500,105500,422000,4/1/2024,User1
2165,18,1,GP,PR,316500,105500,422000,4/1/2024,User1
2166,18,1,GP,PR,316500,105500,422000,4/1/2024,User1
2167,18,1,GP,PR,316500,105500,422000,4/1/2024,User1
2168,18,1,GP,PR,316500,105500,422000,4/1/2024,User1
2169,18,1,GP,PR,316500,105500,422000,4/1/2024,User1
2170,18,1,GP,PR,316500,105500,422000,4/1/2024,User1
2171,18,1,GP,PR,316500,105500,422000,4/1/2024,User1
2172,18,1,GP,PR,316500,105500,422000,4/1/2024,User1
2173,18,1,GP,PR,316500,105500,422000,4/1/2024,User1
2174,18,1,GP,PR,316500,105500,422000,4/1/2024,User1
2175,18,1,GP,PR,316500,105500,422000,4/1/2024,User1
2176,18,1,GP,PR,316500,105500,422000,4/1/2024,User1
2177,18,1,GP,PR,316500,105500,422000,4/1/2024,User1
2178,18,1,LL,SP,80250,26750,107000,4/2/2024,User1
2179,18,1,LL,SP,80250,26750,107000,4/2/2024,User1
2180,18,1,LL,PR,87750,29250,117000,4/2/2024,User1
2181,18,1,LL,PR,87750,29250,117000,4/2/2024,User1
2182,18,1,LL,PR,87750,29250,117000,4/2/2024,User1
2183,18,1,LL,PR,87750,29250,117000,4/2/2024,User1
2184,18,1,LL,PR,87750,29250,117000,4/2/2024,User1
2185,18,1,LL,PR,87750,29250,117000,4/2/2024,User1
2186,18,1,LL,PR,87750,29250,117000,4/2/2024,User1
2187,18,1,LL,PR,87750,29250,117000,4/2/2024,User1
2188,18,1,LL,PR,87750,29250,117000,4/2/2024,User1
2189,18,1,LL,PR,87750,29250,117000,4/2/2024,User1
2190,18,1,LL,PR,87750,29250,117000,4/2/2024,User1
2191,18,1,LL,PR,87750,29250,117000,4/2/2024,User1
2192,18,1,LL,PR,87750,29250,117000,4/2/2024,User1
2193,18,1,LL,PR,87750,29250,117000,4/2/2024,User1
2194,18,1,LL,PR,87750,29250,117000,4/2/2024,User1
2195,18,1,LL,PR,87750,29250,117000,4/2/2024,User1
2196,18,1,LL,PR,87750,29250,117000,4/2/2024,User1
2197,18,1,LL-S,PM,75000,25000,100000,4/2/2024,User1
2198,18,1,LL-S,PM,75000,25000,100000,4/2/2024,User1
2199,18,1,LL-S,PM,75000,25000,100000,4/2/2024,User1
2200,18,1,LL-S,PM,75000,25000,100000,4/2/2024,User1
2201,18,1,LL-S,PM,75000,25000,100000,4/2/2024,User1
2202,18,1,LL-S,PM,75000,25000,100000,4/2/2024,User1
2203,18,1,LL-S,PM,75000,25000,100000,4/2/2024,User1
2204,18,1,LL-S,PM,75000,25000,100000,4/2/2024,User1
2205,18,1,LL-S,PM,75000,25000,100000,4/2/2024,User1
2206,18,1,LL-S,PM,75000,25000,100000,4/2/2024,User1
2207,18,1,LL-S,PM,75000,25000,100000,4/2/2024,User1
2208,18,1,LL-S,PM,75000,25000,100000,4/2/2024,User1
2209,18,1,LL-S,PM,75000,25000,100000,4/2/2024,User1
2210,18,1,LL-S,PM,75000,25000,100000,4/2/2024,User1
2211,18,1,LL-S,PM,75000,25000,100000,4/2/2024,User1
2212,18,1,LL-S,PM,75000,25000,100000,4/2/2024,User1
2213,18,1,LL-S,PM,75000,25000,100000,4/2/2024,User1
2214,18,1,LL-S,SP,80250,26750,107000,4/2/2024,User1
2215,18,1,LL-S,SP,80250,26750,107000,4/2/2024,User1
2216,18,1,LL-S,SP,80250,26750,107000,4/2/2024,User1
2217,18,1,LL-S,SP,80250,26750,107000,4/2/2024,User1
2218,18,1,LL-S,SP,80250,26750,107000,4/2/2024,User1
2219,18,1,LL-S,SP,80250,26750,107000,4/2/2024,User1
2220,18,1,LL-S,SP,80250,26750,107000,4/2/2024,User1
2221,18,1,LL-S,SP,80250,26750,107000,4/2/2024,User1
2222,18,1,LL-S,SP,80250,26750,107000,4/2/2024,User1
2223,18,1,LL-S,SP,80250,26750,107000,4/2/2024,User1
2224,18,1,LL-S,SP,80250,26750,107000,4/2/2024,User1
2225,18,1,LL-S,SP,80250,26750,107000,4/2/2024,User1
2226,18,1,LL-S,SP,80250,26750,107000,4/2/2024,User1
2227,18,1,LL-S,SP,80250,26750,107000,4/2/2024,User1
2228,18,1,LL-S,SP,80250,26750,107000,4/2/2024,User1
2229,18,1,LL-S,SP,80250,26750,107000,4/2/2024,User1
2230,18,1,LL-S,SP,80250,26750,107000,4/2/2024,User1
2231,18,1,LL-S,PR,87750,29250,117000,4/2/2024,User1
2232,18,1,LL-S,PR,87750,29250,117000,4/2/2024,User1
2233,18,1,LL-S,PR,87750,29250,117000,4/2/2024,User1
2234,18,1,LL-S,PR,87750,29250,117000,4/2/2024,User1
2235,18,1,LL-S,PR,87750,29250,117000,4/2/2024,User1
2236,18,1,LL-S,PR,87750,29250,117000,4/2/2024,User1
2237,18,1,LL-S,PR,87750,29250,117000,4/2/2024,User1
2238,18,1,LL-S,PR,87750,29250,117000,4/2/2024,User1
2239,18,1,LL-S,PR,87750,29250,117000,4/2/2024,User1
2240,18,1,LL-S,PR,87750,29250,117000,4/2/2024,User1
2241,18,1,LL-S,PR,87750,29250,117000,4/2/2024,User1
2242,18,1,LL-S,PR,87750,29250,117000,4/2/2024,User1
2243,18,1,LL-S,PR,87750,29250,117000,4/2/2024,User1
2244,18,1,LL-S,PR,87750,29250,117000,4/2/2024,User1
2245,18,1,LL-S,PR,87750,29250,117000,4/2/2024,User1
2246,18,1,LL-S,PR,87750,29250,117000,4/2/2024,User1
2247,18,1,LL-S,PR,87750,29250,117000,4/2/2024,User1
2248,18,1,FE,FE12-PM,1125000,375000,1500000,4/2/2024,User1
2249,18,1,FE,FE12-PM,1125000,375000,1500000,4/2/2024,User1
2250,18,1,FE,FE12-PM,1125000,375000,1500000,4/2/2024,User1
2251,18,1,FE,FE12-PM,1125000,375000,1500000,4/2/2024,User1
2252,18,1,FE,FE12-PM,1125000,375000,1500000,4/2/2024,User1
2253,18,1,FE,FE12-PM,1125000,375000,1500000,4/2/2024,User1
2254,18,1,FE,FE12-PM,1125000,375000,1500000,4/2/2024,User1
2255,18,1,FE,FE12-PM,1125000,375000,1500000,4/2/2024,User1
2256,18,1,FE,FE12-PM,1125000,375000,1500000,4/2/2024,User1
2257,18,1,FE,FE12-PM,1125000,375000,1500000,4/2/2024,User1
2258,18,1,FE,FE12-PM,1125000,375000,1500000,4/2/2024,User1
2259,18,1,FE,FE12-PM,1125000,375000,1500000,4/2/2024,User1
2260,18,1,FE,FE12-PM,1125000,375000,1500000,4/2/2024,User1
2261,18,1,FE,FE12-PM,1125000,375000,1500000,4/2/2024,User1
2262,18,1,FE,FE12-PM,1125000,375000,1500000,4/2/2024,User1
2263,18,1,FE,FE12-PM,1125000,375000,1500000,4/2/2024,User1
2264,18,1,FE,FE19-PM,1781250,593750,2375000,4/2/2024,User1
2265,18,1,FE,FE19-PM,1781250,593750,2375000,4/2/2024,User1
2266,18,1,FE,FE19-PM,1781250,593750,2375000,4/2/2024,User1
2267,18,1,FE,FE19-PM,1781250,593750,2375000,4/2/2024,User1
2268,18,1,FE,FE19-PM,1781250,593750,2375000,4/2/2024,User1
2269,18,1,FE,FE19-PM,1781250,593750,2375000,4/2/2024,User1
2270,18,1,FE,FE19-PM,1781250,593750,2375000,4/2/2024,User1
2271,18,1,FE,FE19-PM,1781250,593750,2375000,4/2/2024,User1
2272,18,1,FE,FE19-PM,1781250,593750,2375000,4/2/2024,User1
2273,18,1,FE,FE19-PM,1781250,593750,2375000,4/2/2024,User1
2274,18,1,FE,FE19-PM,1781250,593750,2375000,4/2/2024,User1
2275,18,1,FE,FE19-PM,1781250,593750,2375000,4/2/2024,User1
2276,18,1,FE,FE19-PM,1781250,593750,2375000,4/2/2024,User1
2277,18,1,FE,FE19-PM,1781250,593750,2375000,4/2/2024,User1
2278,18,1,FE,FE19-PM,1781250,593750,2375000,4/2/2024,User1
2279,18,1,FE,FE19-PM,1781250,593750,2375000,4/2/2024,User1
2280,18,1,FE,FE19-PM,1781250,593750,2375000,4/2/2024,User1
2281,18,1,FE,FE19-PM,1781250,593750,2375000,4/2/2024,User1
2282,18,1,FE,FE19-PM,1781250,593750,2375000,4/2/2024,User1
2283,18,1,LLO,PR,45750,15250,61000,4/2/2024,User1
2284,18,1,LLO,PR,45750,15250,61000,4/2/2024,User1
2285,18,1,LLO,PR,45750,15250,61000,4/2/2024,User1
2286,18,1,LLO,PR,45750,15250,61000,4/2/2024,User1
2287,18,1,LLO,PR,45750,15250,61000,4/2/2024,User1
2288,18,1,LLO,PR,45750,15250,61000,4/2/2024,User1
2289,18,1,LLO,PR,45750,15250,61000,4/2/2024,User1
2290,18,1,LLO,PR,45750,15250,61000,4/2/2024,User1
2291,18,1,GP,PM,270000,90000,360000,4/2/2024,User1
2292,18,1,GP,PM,270000,90000,360000,4/2/2024,User1
2293,18,1,GP,PM,270000,90000,360000,4/2/2024,User1
2294,18,1,GP,PM,270000,90000,360000,4/2/2024,User1
2295,18,1,GP,PM,270000,90000,360000,4/2/2024,User1
2296,18,1,GP,PM,270000,90000,360000,4/2/2024,User1
2297,18,1,GP,PM,270000,90000,360000,4/2/2024,User1
2298,18,1,GP,PM,270000,90000,360000,4/2/2024,User1
2299,18,1,GP,PM,270000,90000,360000,4/2/2024,User1
2300,18,1,GP,PM,270000,90000,360000,4/2/2024,User1
2301,18,1,GP,PM,270000,90000,360000,4/2/2024,User1
2302,18,1,GP,PM,270000,90000,360000,4/2/2024,User1
2303,18,1,GP,SP,289500,96500,386000,4/2/2024,User1
2304,18,1,GP,SP,289500,96500,386000,4/2/2024,User1
2305,18,1,GP,SP,289500,96500,386000,4/2/2024,User1
2306,18,1,GP,SP,289500,96500,386000,4/2/2024,User1
2307,18,1,GP,SP,289500,96500,386000,4/2/2024,User1
2308,18,1,GP,SP,289500,96500,386000,4/2/2024,User1
2309,18,1,GP,SP,289500,96500,386000,4/2/2024,User1
2310,18,1,GP,SP,289500,96500,386000,4/2/2024,User1
2311,18,1,GP,SP,289500,96500,386000,4/2/2024,User1
2312,18,1,GP,SP,289500,96500,386000,4/2/2024,User1
2313,18,1,GP,SP,289500,96500,386000,4/2/2024,User1
2314,18,1,GP,SP,289500,96500,386000,4/2/2024,User1
2315,18,1,GP,SP,289500,96500,386000,4/2/2024,User1
2316,18,1,GP,SP,289500,96500,386000,4/2/2024,User1
2317,18,1,GP,SP,289500,96500,386000,4/2/2024,User1
2318,18,1,GP,SP,289500,96500,386000,4/2/2024,User1
2319,18,1,GP,SP,289500,96500,386000,4/2/2024,User1
2320,18,1,GP,PR,316500,105500,422000,4/2/2024,User1
2321,18,1,GP,PR,316500,105500,422000,4/2/2024,User1
2322,18,1,GP,PR,316500,105500,422000,4/2/2024,User1
2323,18,1,GP,PR,316500,105500,422000,4/2/2024,User1
2324,18,1,GP,PR,316500,105500,422000,4/2/2024,User1
2325,18,1,GP,PR,316500,105500,422000,4/2/2024,User1
2326,18,1,GP,PR,316500,105500,422000,4/2/2024,User1
2327,18,1,GP,PR,316500,105500,422000,4/2/2024,User1
2328,18,1,GP,PR,316500,105500,422000,4/2/2024,User1
2329,18,1,GP,PR,316500,105500,422000,4/2/2024,User1
2330,18,1,GP,PR,316500,105500,422000,4/2/2024,User1
2331,18,1,GP,PR,316500,105500,422000,4/2/2024,User1
2332,18,1,GP,PR,316500,105500,422000,4/2/2024,User1
2333,18,1,GP,PR,316500,105500,422000,4/2/2024,User1
2334,18,1,GP,PR,316500,105500,422000,4/2/2024,User1
2335,18,1,GP,PR,316500,105500,422000,4/2/2024,User1
2336,18,1,GP,PR,316500,105500,422000,4/2/2024,User1
2337,18,1,GP,PR,421500,140500,562000,4/2/2024,User1
2338,18,1,GP,PR,421500,140500,562000,4/2/2024,User1
2339,18,1,GP,PR,421500,140500,562000,4/2/2024,User1
2340,18,1,GP,PR,421500,140500,562000,4/2/2024,User1
2341,18,1,GP,PR,421500,140500,562000,4/2/2024,User1
2342,18,1,GP,PR,421500,140500,562000,4/2/2024,User1
2343,18,1,GP,PR,421500,140500,562000,4/2/2024,User1
2344,18,1,GP,PR,421500,140500,562000,4/2/2024,User1
2345,18,1,GP,PR,421500,140500,562000,4/2/2024,User1
2346,18,1,GP,PR,421500,140500,562000,4/2/2024,User1
2347,18,1,GP,PR,421500,140500,562000,4/2/2024,User1
2348,18,1,GP,PR,421500,140500,562000,4/2/2024,User1
2349,18,1,GP,PR,421500,140500,562000,4/2/2024,User1
2350,18,1,GP,PR,421500,140500,562000,4/2/2024,User1
2351,18,1,GP,PR,421500,140500,562000,4/2/2024,User1
2352,18,1,GP,PR,421500,140500,562000,4/2/2024,User1
2353,18,1,GP,PR,421500,140500,562000,4/2/2024,User1
2354,18,1,LL,PM,75000,25000,100000,4/2/2024,User1
2355,18,1,LL,PM,75000,25000,100000,4/2/2024,User1
2356,18,1,LL,PM,75000,25000,100000,4/2/2024,User1
2357,18,1,LL,PM,75000,25000,100000,4/2/2024,User1
2358,18,1,LL,PM,75000,25000,100000,4/2/2024,User1
2359,18,1,LL,PM,75000,25000,100000,4/2/2024,User1
2360,18,1,LL,PM,75000,25000,100000,4/2/2024,User1
2361,18,1,LL,PM,75000,25000,100000,4/2/2024,User1
2362,18,1,LL,SP,80250,26750,107000,4/26/2024,User1
2363,18,1,LL,SP,80250,26750,107000,4/26/2024,User1
2364,18,1,LL,PR,87750,29250,117000,4/26/2024,User1
2365,18,1,LL,PR,87750,29250,117000,4/26/2024,User1
2366,18,1,LL,PR,87750,29250,117000,4/26/2024,User1
2367,18,1,LL,PR,87750,29250,117000,4/26/2024,User1
2368,18,1,LL,PR,87750,29250,117000,4/26/2024,User1
2369,18,1,LL,PR,87750,29250,117000,4/26/2024,User1
2370,18,1,LL,PR,87750,29250,117000,4/26/2024,User1
2371,18,1,LL,PR,87750,29250,117000,4/26/2024,User1
2372,18,1,LL,PR,87750,29250,117000,4/26/2024,User1
2373,18,1,LL,PR,87750,29250,117000,4/26/2024,User1
2374,18,1,LL,PR,87750,29250,117000,4/26/2024,User1
2375,18,1,LL,PR,87750,29250,117000,4/26/2024,User1
2376,18,1,LL,PR,87750,29250,117000,4/26/2024,User1
2377,18,1,LL,PR,87750,29250,117000,4/26/2024,User1
2378,18,1,LL,PR,87750,29250,117000,4/26/2024,User1
2379,18,1,LL,PR,87750,29250,117000,4/26/2024,User1
2380,18,1,LL,PR,87750,29250,117000,4/26/2024,User1
2381,18,1,LL-S,PM,75000,25000,100000,4/26/2024,User1
2382,18,1,LL-S,PM,75000,25000,100000,4/26/2024,User1
2383,18,1,LL-S,PM,75000,25000,100000,4/26/2024,User1
2384,18,1,LL-S,PM,75000,25000,100000,4/26/2024,User1
2385,18,1,LL-S,PM,75000,25000,100000,4/26/2024,User1
2386,18,1,LL-S,PM,75000,25000,100000,4/26/2024,User1
2387,18,1,LL-S,PM,75000,25000,100000,4/26/2024,User1
2388,18,1,LL-S,PM,75000,25000,100000,4/26/2024,User1
2389,18,1,LL-S,PM,75000,25000,100000,4/26/2024,User1
2390,18,1,LL-S,PM,75000,25000,100000,4/26/2024,User1
2391,18,1,LL-S,PM,75000,25000,100000,4/26/2024,User1
2392,18,1,LL-S,PM,75000,25000,100000,4/26/2024,User1
2393,18,1,LL-S,PM,75000,25000,100000,4/26/2024,User1
2394,18,1,LL-S,PM,75000,25000,100000,4/26/2024,User1
2395,18,1,LL-S,PM,75000,25000,100000,4/26/2024,User1
2396,18,1,LL-S,PM,75000,25000,100000,4/26/2024,User1
2397,18,1,LL-S,PM,75000,25000,100000,4/26/2024,User1
2398,18,1,LL-S,SP,80250,26750,107000,4/26/2024,User1
2399,18,1,LL-S,SP,80250,26750,107000,4/26/2024,User1
2400,18,1,LL-S,SP,80250,26750,107000,4/26/2024,User1
2401,18,1,LL-S,SP,80250,26750,107000,4/26/2024,User1
2402,18,1,LL-S,SP,80250,26750,107000,4/26/2024,User1
2403,18,1,LL-S,SP,80250,26750,107000,4/26/2024,User1
2404,18,1,LL-S,SP,80250,26750,107000,4/26/2024,User1
2405,18,1,LL-S,SP,80250,26750,107000,4/26/2024,User1
2406,18,1,LL-S,SP,80250,26750,107000,4/26/2024,User1
2407,18,1,LL-S,SP,80250,26750,107000,4/26/2024,User1
2408,18,1,LL-S,SP,80250,26750,107000,4/26/2024,User1
2409,18,1,LL-S,SP,80250,26750,107000,4/26/2024,User1
2410,18,1,LL-S,SP,80250,26750,107000,4/26/2024,User1
2411,18,1,LL-S,SP,80250,26750,107000,4/26/2024,User1
2412,18,1,LL-S,SP,80250,26750,107000,4/26/2024,User1
2413,18,1,LL-S,SP,80250,26750,107000,4/26/2024,User1
2414,18,1,LL-S,SP,80250,26750,107000,4/26/2024,User1
2415,18,1,LL-S,PR,87750,29250,117000,4/26/2024,User1
2416,18,1,LL-S,PR,87750,29250,117000,4/26/2024,User1
2417,18,1,LL-S,PR,87750,29250,117000,4/26/2024,User1
2418,18,1,LL-S,PR,87750,29250,117000,4/26/2024,User1
2419,18,1,LL-S,PR,87750,29250,117000,4/26/2024,User1
2420,18,1,LL-S,PR,87750,29250,117000,4/26/2024,User1
2421,18,1,LL-S,PR,87750,29250,117000,4/26/2024,User1
2422,18,1,LL-S,PR,87750,29250,117000,4/26/2024,User1
2423,18,1,LL-S,PR,87750,29250,117000,4/26/2024,User1
2424,18,1,LL-S,PR,87750,29250,117000,4/26/2024,User1
2425,18,1,LL-S,PR,87750,29250,117000,4/26/2024,User1
2426,18,1,LL-S,PR,87750,29250,117000,4/26/2024,User1
2427,18,1,LL-S,PR,87750,29250,117000,4/26/2024,User1
2428,18,1,LL-S,PR,87750,29250,117000,4/26/2024,User1
2429,18,1,LL-S,PR,87750,29250,117000,4/26/2024,User1
2430,18,1,LL-S,PR,87750,29250,117000,4/26/2024,User1
2431,18,1,LL-S,PR,87750,29250,117000,4/26/2024,User1
2432,18,1,FE,FE12-PM,1125000,375000,1500000,4/26/2024,User1
2433,18,1,FE,FE12-PM,1125000,375000,1500000,4/26/2024,User1
2434,18,1,FE,FE12-PM,1125000,375000,1500000,4/26/2024,User1
2435,18,1,FE,FE12-PM,1125000,375000,1500000,4/26/2024,User1
2436,18,1,FE,FE12-PM,1125000,375000,1500000,4/26/2024,User1
2437,18,1,FE,FE12-PM,1125000,375000,1500000,4/26/2024,User1
2438,18,1,FE,FE12-PM,1125000,375000,1500000,4/26/2024,User1
2439,18,1,FE,FE12-PM,1125000,375000,1500000,4/26/2024,User1
2440,18,1,FE,FE12-PM,1125000,375000,1500000,4/26/2024,User1
2441,18,1,FE,FE12-PM,1125000,375000,1500000,4/26/2024,User1
2442,18,1,FE,FE12-PM,1125000,375000,1500000,4/26/2024,User1
2443,18,1,FE,FE12-PM,1125000,375000,1500000,4/26/2024,User1
2444,18,1,FE,FE12-PM,1125000,375000,1500000,4/26/2024,User1
2445,18,1,FE,FE12-PM,1125000,375000,1500000,4/26/2024,User1
2446,18,1,FE,FE12-PM,1125000,375000,1500000,4/26/2024,User1
2447,18,1,FE,FE12-PM,1125000,375000,1500000,4/26/2024,User1
2448,18,1,FE,FE19-PM,1781250,593750,2375000,4/26/2024,User1
2449,18,1,FE,FE19-PM,1781250,593750,2375000,4/26/2024,User1
2450,18,1,FE,FE19-PM,1781250,593750,2375000,4/26/2024,User1
2451,18,1,FE,FE19-PM,1781250,593750,2375000,4/26/2024,User1
2452,18,1,FE,FE19-PM,1781250,593750,2375000,4/26/2024,User1
2453,21,1,LL,PR,91500,30500,122000,5/23/2024,User1
2454,21,1,LL,SP,78750,26250,105000,5/23/2024,User1
2455,21,1,LL-S,PM,90000,30000,120000,5/23/2024,User1
2456,21,1,LL-S,PR,97500,32500,130000,5/23/2024,User1
2457,21,1,LL-S,SP,93750,31250,125000,5/23/2024,User1
2458,21,1,FE,FE12,1152000,384000,1536000,5/23/2024,User1
2459,21,1,FE,PM,1152000,384000,1536000,5/23/2024,User1
2460,21,1,FE,PR,1215000,405000,1620000,5/23/2024,User1
2461,21,1,FE,PR,1316250,438750,1755000,5/23/2024,User1
2462,21,1,FE,PR,2700000,900000,3600000,5/23/2024,User1
2463,21,1,FE,SP,1179000,393000,1572000,5/23/2024,User1
2464,21,1,FE,SP,2520000,840000,3360000,5/23/2024,User1
2465,21,1,FP,PM,614250,204750,819000,5/23/2024,User1
2466,21,1,FP,PR,843750,281250,1125000,5/23/2024,User1
2467,21,1,FP,PR,1125000,375000,1500000,5/23/2024,User1
2468,21,1,FP,PR,1312500,437500,1750000,5/23/2024,User1
2469,21,1,FP,SP,640500,213500,854000,5/23/2024,User1
2470,21,1,FP,SP,732000,244000,976000,5/23/2024,User1
2471,21,1,GPT,PR,274500,91500,366000,5/23/2024,User1
2472,21,1,GPT,SP,263250,87750,351000,5/23/2024,User1
2473,21,1,LL,PM,74250,24750,99000,5/23/2024,User1
2474,21,1,LLO,PR,36000,12000,48000,5/23/2024,User1
2475,21,1,OSY,PR,36000,12000,48000,5/23/2024,User1
2476,21,1,LL,PM,74250,24750,99000,9/30/2024,User1
2477,21,1,LL,SP,78750,26250,105000,9/30/2024,User1
2478,21,1,GPT,SP,263250,87750,351000,9/30/2024,User1
2479,21,1,GPT,PR,274500,91500,366000,9/30/2024,User1
2480,21,1,FE,FE12,1152000,384000,1536000,9/30/2024,User1
2481,21,1,FE,PM,1152000,384000,1536000,9/30/2024,User1
2482,21,1,FE,SP,1179000,393000,1572000,9/30/2024,User1
2483,21,1,FE,PR,1215000,405000,1620000,9/30/2024,User1
2484,21,1,FE,PR,1316250,438750,1755000,9/30/2024,User1
2485,21,1,FP,PM,614250,204750,819000,9/30/2024,User1
2486,21,1,FP,SP,640500,213500,854000,9/30/2024,User1
2487,21,1,FP,SP,732000,244000,976000,9/30/2024,User1
2488,21,1,FP,PR,843750,281250,1125000,9/30/2024,User1
2489,21,1,FP,PR,1125000,375000,1500000,9/30/2024,User1
2490,21,1,FP,PR,1312500,437500,1750000,9/30/2024,User1
2491,21,1,OSY,PR,36000,12000,48000,9/30/2024,User1
2492,21,1,FE,PR,2700000,900000,3600000,9/30/2024,User1
2493,21,1,FE,SP,2520000,840000,3360000,9/30/2024,User1
2494,21,1,LL,PR,91500,30500,115000,9/30/2024,User1
2495,21,1,FP,SP,732000,244000,920000,9/30/2024,User1
2496,21,1,FP,SP,640500,213500,854000,9/29/2024,User1
2497,21,1,FP,SP,732000,244000,976000,9/29/2024,User1
2498,21,1,FP,PR,843750,281250,1125000,9/29/2024,User1
2499,21,1,FP,PR,1125000,375000,1500000,9/29/2024,User1
2500,21,1,FP,PR,1312500,437500,1750000,9/29/2024,User1
2501,21,1,LL,PM,74250,24750,99000,9/29/2024,User1
2502,21,1,LL,SP,78750,26250,105000,9/29/2024,User1
2503,21,1,GPT,SP,263250,87750,351000,9/29/2024,User1
2504,21,1,GPT,PR,274500,91500,366000,9/29/2024,User1
2505,21,1,FE,FE12,1152000,384000,1536000,9/29/2024,User1
2506,21,1,FE,PM,1152000,384000,1536000,9/29/2024,User1
2507,21,1,FE,SP,1179000,393000,1572000,9/29/2024,User1
2508,21,1,FE,PR,1215000,405000,1620000,9/29/2024,User1
2509,21,1,FE,PR,1316250,438750,1755000,9/29/2024,User1
2510,21,1,FP,PM,614250,204750,819000,9/29/2024,User1
2511,21,1,OSY,PR,36000,12000,48000,9/29/2024,User1
2512,21,1,FE,PR,2700000,900000,3600000,9/29/2024,User1
2513,21,1,FE,SP,2520000,840000,3360000,9/29/2024,User1
2514,21,1,LL,PR,86250,28750,115000,9/29/2024,User1
2515,21,1,FP,SP,732000,244000,920000,9/29/2024,User1
2516,21,1,FP,PR,1125000,375000,1500000,7/3/2024,User1
2517,21,1,FP,PR,1312500,437500,1750000,7/3/2024,User1
2518,21,1,LL,PM,74250,24750,99000,7/3/2024,User1
2519,21,1,LL,SP,78750,26250,105000,7/3/2024,User1
2520,21,1,GPT,SP,263250,87750,351000,7/3/2024,User1
2521,21,1,GPT,PR,274500,91500,366000,7/3/2024,User1
2522,21,1,FE,FE12,1152000,384000,1536000,7/3/2024,User1
2523,21,1,FE,PM,1152000,384000,1536000,7/3/2024,User1
2524,21,1,FE,SP,1179000,393000,1572000,7/3/2024,User1
2525,21,1,FE,PR,1215000,405000,1620000,7/3/2024,User1
2526,21,1,FE,PR,1316250,438750,1755000,7/3/2024,User1
2527,21,1,FP,PM,614250,204750,819000,7/3/2024,User1
2528,21,1,FP,SP,640500,213500,854000,7/3/2024,User1
2529,21,1,FP,SP,732000,244000,976000,7/3/2024,User1
2530,21,1,FP,PR,843750,281250,1125000,7/3/2024,User1
2531,21,1,LL,PM,72000,24000,96000,5/2/2024,User1
2532,21,1,LL,SP,75000,25000,100000,5/2/2024,User1
2533,21,1,LL,PR,82500,27500,110000,5/2/2024,User1
2534,21,1,GPT,SP,258750,86250,345000,5/2/2024,User1
2535,21,1,GPT,PR,270000,90000,360000,5/2/2024,User1
2536,21,1,FE,FE12,990000,330000,1320000,5/2/2024,User1
2537,21,1,FE,PM,990000,330000,1320000,5/2/2024,User1
2538,21,1,FE,SP,1035000,345000,1380000,5/2/2024,User1
2539,21,1,FE,PR,1080000,360000,1440000,5/2/2024,User1
2540,21,1,FE,PR,1170000,390000,1560000,5/2/2024,User1
2541,21,1,FP,PM,577500,192500,770000,5/2/2024,User1
2542,21,1,FP,SP,603750,201250,805000,5/2/2024,User1
2543,21,1,FP,SP,690000,230000,920000,5/2/2024,User1
2544,21,1,FP,PR,810000,270000,1080000,5/2/2024,User1
2545,21,1,FP,PR,1080000,360000,1440000,5/2/2024,User1
2546,21,1,FP,PR,1260000,420000,1680000,5/2/2024,User1
2547,21,1,GPT,PR,270000,90000,360000,2/24/2024,User1
2548,21,1,FE,FE12,990000,330000,1320000,2/24/2024,User1
2549,21,1,FE,PM,990000,330000,1320000,2/24/2024,User1
2550,21,1,FE,SP,1035000,345000,1380000,2/24/2024,User1
2551,21,1,FE,PR,1080000,360000,1440000,2/24/2024,User1
2552,21,1,FE,PR,1170000,390000,1560000,2/24/2024,User1
2553,21,1,FP,PM,577500,192500,770000,2/24/2024,User1
2554,21,1,FP,SP,603750,201250,805000,2/24/2024,User1
2555,21,1,FP,PR,810000,270000,1080000,2/24/2024,User1
2556,21,1,FP,PR,1080000,360000,1440000,2/24/2024,User1
2557,21,1,FP,PR,1260000,420000,1680000,2/24/2024,User1
2558,21,1,LL,SP,75000,25000,100000,2/24/2024,User1
2559,21,1,LL,PR,82500,27500,110000,2/24/2024,User1
2560,21,1,GPT,SP,258750,86250,345000,2/24/2024,User1
2561,21,1,FP,SP,690000,230000,920000,2/24/2024,User1
2562,21,1,LL,PM,72000,24000,96000,2/24/2024,User1
2563,21,1,LLO,PR,33750,11250,45000,2/24/2024,User1
2564,21,1,LL,PR,90000,30000,120000,4/26/2024,User1
2565,21,1,FP,PR,1260000,420000,1680000,4/26/2024,User1
2566,21,1,LL,PM,72000,24000,96000,4/26/2024,User1
2567,21,1,LL,SP,75000,25000,100000,4/26/2024,User1
2568,21,1,LL,PR,82500,27500,110000,4/26/2024,User1
2569,21,1,GPT,SP,258750,86250,345000,4/26/2024,User1
2570,21,1,GPT,PR,270000,90000,360000,4/26/2024,User1
2571,21,1,FE,FE12,990000,330000,1320000,4/26/2024,User1
2572,21,1,FE,PM,990000,330000,1320000,4/26/2024,User1
2573,21,1,FE,SP,1035000,345000,1380000,4/26/2024,User1
2574,21,1,FE,PR,1080000,360000,1440000,4/26/2024,User1
2575,21,1,FE,PR,1170000,390000,1560000,4/26/2024,User1
2576,21,1,FP,PM,577500,192500,770000,4/26/2024,User1
2577,21,1,FP,SP,603750,201250,805000,4/26/2024,User1
2578,21,1,FP,SP,690000,230000,920000,4/26/2024,User1
2579,21,1,FP,PR,810000,270000,1080000,4/26/2024,User1
2580,21,1,FP,PR,1080000,360000,1440000,4/26/2024,User1
2581,21,1,FE,PR,1215000,405000,1620000,5/6/2024,User1
2582,21,1,FE,PR,1316250,438750,1755000,5/6/2024,User1
2583,21,1,FP,PM,614250,204750,819000,5/6/2024,User1
2584,21,1,FP,SP,640500,213500,854000,5/6/2024,User1
2585,21,1,FP,SP,732000,244000,976000,5/6/2024,User1
2586,21,1,FP,PR,843750,281250,1125000,5/6/2024,User1
2587,21,1,FP,PR,1125000,375000,1500000,5/6/2024,User1
2588,21,1,FP,PR,1312500,437500,1750000,5/6/2024,User1
2589,21,1,LL,PM,74250,24750,99000,5/6/2024,User1
2590,21,1,LL,SP,78750,26250,105000,5/6/2024,User1
2591,21,1,GPT,SP,263250,87750,351000,5/6/2024,User1
2592,21,1,GPT,PR,274500,91500,366000,5/6/2024,User1
2593,21,1,FE,FE12,1152000,384000,1536000,5/6/2024,User1
2594,21,1,FE,PM,1152000,384000,1536000,5/6/2024,User1
2595,21,1,FE,SP,1179000,393000,1572000,5/6/2024,User1
2596,21,1,OSY,PR,36000,12000,48000,5/6/2024,User1
2597,21,1,FE,PR,2700000,900000,3600000,5/6/2024,User1
2598,21,1,FE,SP,2520000,840000,3360000,5/6/2024,User1
2599,21,1,LL,PR,91500,30500,122000,5/6/2024,User1
2600,21,1,FP,SP,732000,244000,920000,5/6/2024,User1
2601,21,1,OSY,PR,33750,11250,45000,4/26/2024,User1
2602,21,1,FE,PR,2430000,810000,3240000,4/26/2024,User1
2603,21,1,FE,SP,2610000,870000,3480000,4/26/2024,User1
2604,21,1,FE,SP,2430000,810000,3240000,4/26/2024,User1
2605,21,1,FE,PR,2610000,870000,3480000,4/26/2024,User1
2606,21,1,LL,SP,75000,25000,100000,4/27/2024,User1
2607,21,1,GPT,SP,258750,86250,345000,4/27/2024,User1
2608,21,1,FE,FE12,990000,330000,1320000,4/27/2024,User1
2609,21,1,FE,SP,1035000,345000,1380000,4/27/2024,User1
2610,21,1,FE,PR,1080000,360000,1440000,4/27/2024,User1
2611,21,1,FE,PR,1170000,390000,1560000,4/27/2024,User1
2612,21,1,FP,PM,577500,192500,770000,4/27/2024,User1
2613,21,1,FP,SP,603750,201250,805000,4/27/2024,User1
2614,21,1,FP,SP,690000,230000,920000,4/27/2024,User1
2615,21,1,FP,PR,810000,270000,1080000,4/27/2024,User1
2616,21,1,FP,PR,1080000,360000,1440000,4/27/2024,User1
2617,21,1,FP,PR,1260000,420000,1680000,4/27/2024,User1
2618,21,1,LL,PM,72000,24000,96000,4/27/2024,User1
2619,21,1,GPT,PR,270000,90000,360000,4/27/2024,User1
2620,21,1,FE,PM,990000,330000,1320000,4/27/2024,User1
2621,21,1,OSY,PR,33750,11250,45000,5/2/2024,User1
2622,21,1,FE,PR,2430000,810000,3240000,5/2/2024,User1
2623,21,1,FE,SP,2610000,870000,3480000,5/2/2024,User1
2624,21,1,GPT,PR,270000,90000,360000,4/29/2024,User1
2625,21,1,FE,FE12,990000,330000,1320000,4/29/2024,User1
2626,21,1,FE,PM,990000,330000,1320000,4/29/2024,User1
2627,21,1,FE,SP,1035000,345000,1380000,4/29/2024,User1
2628,21,1,OSY,PR,33750,11250,45000,4/27/2024,User1
2629,21,1,FE,PR,2430000,810000,3240000,4/27/2024,User1
2630,21,1,FE,SP,2610000,870000,3480000,4/27/2024,User1
2631,21,1,LL,PR,90000,30000,120000,4/27/2024,User1
2632,21,1,FE,SP,2430000,810000,3240000,4/27/2024,User1
2633,21,1,FE,PR,2610000,870000,3480000,4/27/2024,User1
2634,21,1,FE,SP,1035000,810000,1845000,4/27/2024,User1
2635,21,1,FP,PR,810000,270000,1080000,4/29/2024,User1
2636,21,1,LL,PM,72000,24000,96000,4/29/2024,User1
2637,21,1,FE,PR,1080000,360000,1440000,4/29/2024,User1
2638,21,1,LL,SP,75000,25000,100000,4/29/2024,User1
2639,21,1,GPT,SP,258750,86250,345000,4/29/2024,User1
2640,21,1,FE,PR,1170000,390000,1560000,4/29/2024,User1
2641,21,1,FP,PR,1080000,360000,1440000,4/29/2024,User1
2642,21,1,FP,PR,1260000,420000,1680000,4/29/2024,User1
2643,21,1,FP,SP,690000,230000,920000,5/5/2024,User1
2644,21,1,FP,PR,810000,270000,1080000,5/5/2024,User1
2645,21,1,FP,PR,1080000,360000,1440000,5/5/2024,User1
2646,21,1,FP,PR,1260000,420000,1680000,5/5/2024,User1
2647,21,1,LL,PM,72000,24000,96000,5/5/2024,User1
2648,21,1,LL,SP,75000,25000,100000,5/5/2024,User1
2649,21,1,GPT,SP,258750,86250,345000,5/5/2024,User1
2650,21,1,GPT,PR,270000,90000,360000,5/5/2024,User1
2651,21,1,FE,FE12,990000,330000,1320000,5/5/2024,User1
2652,21,1,FE,PM,990000,330000,1320000,5/5/2024,User1
2653,21,1,FE,SP,1035000,345000,1380000,5/5/2024,User1
2654,21,1,FE,PR,1080000,360000,1440000,5/5/2024,User1
2655,21,1,FE,SP,1035000,810000,1845000,4/26/2024,User1
2656,21,1,FE,PR,1170000,390000,1560000,5/5/2024,User1
2657,21,1,FP,PM,577500,192500,770000,5/5/2024,User1
2658,21,1,FP,SP,603750,201250,805000,5/5/2024,User1
2659,21,1,LL,PR,90000,30000,120000,5/5/2024,User1
2660,21,1,OSY,PR,33750,11250,45000,5/5/2024,User1
2661,21,1,FE,PR,2430000,810000,3240000,5/5/2024,User1
2662,21,1,FE,SP,2610000,870000,3480000,5/5/2024,User1
2663,21,1,FE,SP,2430000,810000,3240000,5/5/2024,User1
2664,21,1,FE,PR,2610000,870000,3480000,5/5/2024,User1
2665,21,1,FP,PM,577500,192500,770000,4/29/2024,User1
2666,21,1,FP,SP,603750,201250,805000,4/29/2024,User1
2667,21,1,FP,SP,690000,230000,920000,4/29/2024,User1
2668,21,1,OSY,PR,33750,11250,45000,4/29/2024,User1
2669,21,1,FE,PR,2430000,810000,3240000,4/29/2024,User1
2670,21,1,FE,SP,2610000,870000,3480000,4/29/2024,User1
2671,21,1,LL,PR,90000,30000,120000,4/29/2024,User1
2672,21,1,FE,SP,2430000,810000,3240000,4/29/2024,User1
2673,21,1,FE,PR,2610000,870000,3480000,4/29/2024,User1
2674,21,1,FE,SP,1035000,810000,1845000,4/29/2024,User1
2675,21,1,FE,SP,1035000,810000,1845000,5/5/2024,User1
2676,21,1,LLO,PR,36000,12000,48000,7/3/2024,User1
2677,21,1,FE,PR,2700000,900000,3600000,7/3/2024,User1
2678,21,1,FE,SP,2520000,840000,3360000,7/3/2024,User1
2679,21,1,LL,PR,86250,28750,115000,7/3/2024,User1
2680,21,1,LL,SP,78750,26250,105000,7/31/2024,User1
2681,21,1,GPT,SP,263250,87750,351000,7/31/2024,User1
2682,21,1,GPT,PR,274500,91500,366000,7/31/2024,User1
2683,21,1,FE,FE12,1152000,384000,1536000,7/31/2024,User1
2684,21,1,FE,PM,1152000,384000,1536000,7/31/2024,User1
2685,21,1,FE,SP,1179000,393000,1572000,7/31/2024,User1
2686,21,1,FE,PR,1215000,405000,1620000,7/31/2024,User1
2687,21,1,FE,PR,1316250,438750,1755000,7/31/2024,User1
2688,21,1,FP,PM,614250,204750,819000,7/31/2024,User1
2689,21,1,FP,SP,640500,213500,854000,7/31/2024,User1
2690,21,1,FP,SP,732000,244000,976000,7/31/2024,User1
2691,21,1,FP,PR,843750,281250,1125000,7/31/2024,User1
2692,21,1,FP,PR,1125000,375000,1500000,7/31/2024,User1
2693,21,1,FP,PR,1312500,437500,1750000,7/31/2024,User1
2694,21,1,LL,PM,74250,24750,99000,7/31/2024,User1
2695,21,1,LLO,PR,36000,12000,48000,7/31/2024,User1
2696,21,1,FE,PR,2700000,900000,3600000,7/31/2024,User1
2697,21,1,FE,SP,2520000,840000,3360000,7/31/2024,User1
2698,21,1,LL,PR,91500,30500,122000,7/31/2024,User1
